Year,State,District,Total_Male,Male_Below_5_years,Male_5_years_&_Above_Below_14_years,Male_14_years_&_Above_Below_18_years,Male_18_years_&_Above_Below_30_years,Male_30_years_&_Above_Below_45_years,Male_45_years_&_Above_Below_60_years,Male_60_years_&_Above,Total_Female,Female_Below_5_years,Female_5_years_&_Above_Below_14_years,Female_14_years_&_Above_Below_18_years,Female_18_years_&_Above_Below_30_years,Female_30_years_&_Above_Below_45_years,Female_45_years_&_Above_Below_60_years,Female_60_years_&_Above,Total_Transgender,Transgender_Below_5_years,Transgender_5_years_&_Above_Below_14_years,Transgender_14_years_&_Above_Below_18_years,Transgender_18_years_&_Above_Below_30_years,Transgender_30_years_&_Above_Below_45_years,Transgender_45_years_&_Above_Below_60_years,Transgender_60_years_&_Above,Grand_Total,Total_Below_5_years,Total_5_years_&_Above_Below_14_years,Total_14_years_&_Above_Below_18_years,Total_18_years_&_Above_Below_30_years,Total_30_years_&_Above_Below_45_years,Total_45_years_&_Above_Below_60_years,Total_60_years_&_Above
2018-19, Andhra Pradesh,Anantapur,257,2,22,36,93,61,26,17,766,1,22,257,415,58,5,8,0,0,0,0,0,0,0,0,1023,3,44,293,508,119,31,25
2018-19, Andhra Pradesh,Chittoor,99,15,13,16,29,14,10,2,319,33,6,112,132,24,9,3,0,0,0,0,0,0,0,0,418,48,19,128,161,38,19,5
2018-19, Andhra Pradesh,Cuddapah,163,2,19,31,26,35,44,6,475,9,31,136,98,126,72,3,0,0,0,0,0,0,0,0,638,11,50,167,124,161,116,9
2018-19, Andhra Pradesh,East Godavari,215,2,6,19,69,70,31,18,359,6,16,80,205,39,6,7,9,1,0,8,0,0,0,0,583,9,22,107,274,109,37,25
2018-19, Andhra Pradesh,Guntakal Railway,6,0,1,0,2,1,0,2,4,0,0,0,2,0,0,2,0,0,0,0,0,0,0,0,10,0,1,0,4,1,0,4
2018-19, Andhra Pradesh,Guntur,279,15,29,41,49,76,46,23,440,13,26,74,230,72,15,10,0,0,0,0,0,0,0,0,719,28,55,115,279,148,61,33
2018-19, Andhra Pradesh,Guntur Urban,202,0,22,21,59,51,25,24,293,2,5,39,205,31,4,7,0,0,0,0,0,0,0,0,495,2,27,60,264,82,29,31
2018-19, Andhra Pradesh,Krishna,182,5,8,0,66,60,32,11,282,9,18,0,193,48,9,5,0,0,0,0,0,0,0,0,464,14,26,0,259,108,41,16
2018-19, Andhra Pradesh,Kurnool,205,3,12,28,67,42,35,18,504,10,44,120,80,135,90,25,0,0,0,0,0,0,0,0,709,13,56,148,147,177,125,43
2018-19, Andhra Pradesh,Nellore,141,1,16,19,35,34,21,15,345,1,18,92,159,54,14,7,0,0,0,0,0,0,0,0,486,2,34,111,194,88,35,22
2018-19, Andhra Pradesh,Prakasham,176,7,30,19,47,34,27,12,344,5,22,69,199,40,5,4,0,0,0,0,0,0,0,0,520,12,52,88,246,74,32,16
2018-19, Andhra Pradesh,Rajahmundry,196,5,14,14,66,55,29,13,233,1,10,40,142,23,9,8,0,0,0,0,0,0,0,0,429,6,24,54,208,78,38,21
2018-19, Andhra Pradesh,Srikakulam,110,6,15,12,25,21,10,21,231,1,7,44,147,24,5,3,0,0,0,0,0,0,0,0,341,7,22,56,172,45,15,24
2018-19, Andhra Pradesh,Tirupathi Urban,132,2,3,9,63,36,19,0,260,1,23,44,36,119,37,0,0,0,0,0,0,0,0,0,392,3,26,53,99,155,56,0
2018-19, Andhra Pradesh,Vijayawada City,410,13,46,49,96,119,59,28,521,22,29,121,263,58,17,11,0,0,0,0,0,0,0,0,931,35,75,170,359,177,76,39
2018-19, Andhra Pradesh,Vijayawada Railway,26,1,0,4,2,9,5,5,12,0,2,0,2,6,1,1,0,0,0,0,0,0,0,0,38,1,2,4,4,15,6,6
2018-19, Andhra Pradesh,Visakha Rural,137,0,15,13,49,27,20,13,187,8,5,18,123,23,3,7,0,0,0,0,0,0,0,0,324,8,20,31,172,50,23,20
2018-19, Andhra Pradesh,Visakhapatnam,310,4,9,7,131,88,47,24,452,3,4,19,323,80,9,14,0,0,0,0,0,0,0,0,762,7,13,26,454,168,56,38
2018-19, Andhra Pradesh,Vizianagaram,109,7,6,11,33,28,17,7,250,7,13,62,141,20,5,2,0,0,0,0,0,0,0,0,359,14,19,73,174,48,22,9
2018-19, Andhra Pradesh,West Godavari,356,22,35,27,91,103,48,30,619,26,36,106,305,109,23,14,0,0,0,0,0,0,0,0,975,48,71,133,396,212,71,44
2018-19, Andhra Pradesh,Total,3711,112,321,376,1098,964,551,289,6896,158,337,1433,3400,1089,338,141,9,1,0,8,0,0,0,0,10616,271,658,1817,4498,2053,889,430
2018-19,Arunachal Pradesh,All Districts,1,0,0,0,1,0,0,0,32,0,13,12,7,0,0,0,0,0,0,0,0,0,0,0,33,0,13,12,8,0,0,0
2018-19,Arunachal Pradesh,Anjaw,0,0,0,0,0,0,0,0,0,0,0,0,0,0,0,0,0,0,0,0,0,0,0,0,0,0,0,0,0,0,0,0
2018-19,Arunachal Pradesh,Changlang,6,0,2,1,2,1,0,0,9,0,2,5,2,0,0,0,0,0,0,0,0,0,0,0,15,0,4,6,4,1,0,0
2018-19,Arunachal Pradesh,Crime Branch,0,0,0,0,0,0,0,0,0,0,0,0,0,0,0,0,0,0,0,0,0,0,0,0,0,0,0,0,0,0,0,0
2018-19,Arunachal Pradesh,Dibang Valley,0,0,0,0,0,0,0,0,0,0,0,0,0,0,0,0,0,0,0,0,0,0,0,0,0,0,0,0,0,0,0,0
2018-19,Arunachal Pradesh,Kameng East,0,0,0,0,0,0,0,0,0,0,0,0,0,0,0,0,0,0,0,0,0,0,0,0,0,0,0,0,0,0,0,0
2018-19,Arunachal Pradesh,Kameng West,0,0,0,0,0,0,0,0,2,0,2,0,0,0,0,0,0,0,0,0,0,0,0,0,2,0,2,0,0,0,0,0
2018-19,Arunachal Pradesh,Kurung Kumey,0,0,0,0,0,0,0,0,0,0,0,0,0,0,0,0,0,0,0,0,0,0,0,0,0,0,0,0,0,0,0,0
2018-19,Arunachal Pradesh,Lohit,0,0,0,0,0,0,0,0,0,0,0,0,0,0,0,0,0,0,0,0,0,0,0,0,0,0,0,0,0,0,0,0
2018-19,Arunachal Pradesh,Longding,0,0,0,0,0,0,0,0,0,0,0,0,0,0,0,0,0,0,0,0,0,0,0,0,0,0,0,0,0,0,0,0
2018-19,Arunachal Pradesh,Lower Dibang Valley,0,0,0,0,0,0,0,0,0,0,0,0,0,0,0,0,0,0,0,0,0,0,0,0,0,0,0,0,0,0,0,0
2018-19,Arunachal Pradesh,Papum Pare Rural,8,0,1,6,1,0,0,0,0,0,0,0,0,0,0,0,0,0,0,0,0,0,0,0,8,0,1,6,1,0,0,0
2018-19,Arunachal Pradesh,Siang East,0,0,0,0,0,0,0,0,0,0,0,0,0,0,0,0,0,0,0,0,0,0,0,0,0,0,0,0,0,0,0,0
2018-19,Arunachal Pradesh,Siang Upper,0,0,0,0,0,0,0,0,0,0,0,0,0,0,0,0,0,0,0,0,0,0,0,0,0,0,0,0,0,0,0,0
2018-19,Arunachal Pradesh,Siang West,0,0,0,0,0,0,0,0,0,0,0,0,0,0,0,0,0,0,0,0,0,0,0,0,0,0,0,0,0,0,0,0
2018-19,Arunachal Pradesh,Subansiri Lower,0,0,0,0,0,0,0,0,0,0,0,0,0,0,0,0,0,0,0,0,0,0,0,0,0,0,0,0,0,0,0,0
2018-19,Arunachal Pradesh,Subansiri Upper,0,0,0,0,0,0,0,0,0,0,0,0,0,0,0,0,0,0,0,0,0,0,0,0,0,0,0,0,0,0,0,0
2018-19,Arunachal Pradesh,Tawang,0,0,0,0,0,0,0,0,0,0,0,0,0,0,0,0,0,0,0,0,0,0,0,0,0,0,0,0,0,0,0,0
2018-19,Arunachal Pradesh,Tirap,0,0,0,0,0,0,0,0,0,0,0,0,0,0,0,0,0,0,0,0,0,0,0,0,0,0,0,0,0,0,0,0
2018-19,Arunachal Pradesh,Namsai,0,0,0,0,0,0,0,0,0,0,0,0,0,0,0,0,0,0,0,0,0,0,0,0,0,0,0,0,0,0,0,0
2018-19,Arunachal Pradesh,Siang,0,0,0,0,0,0,0,0,0,0,0,0,0,0,0,0,0,0,0,0,0,0,0,0,0,0,0,0,0,0,0,0
2018-19,Arunachal Pradesh,Kamle,0,0,0,0,0,0,0,0,0,0,0,0,0,0,0,0,0,0,0,0,0,0,0,0,0,0,0,0,0,0,0,0
2018-19,Arunachal Pradesh,Kra Dadi,0,0,0,0,0,0,0,0,0,0,0,0,0,0,0,0,0,0,0,0,0,0,0,0,0,0,0,0,0,0,0,0
2018-19,Arunachal Pradesh,Lower Siang,0,0,0,0,0,0,0,0,0,0,0,0,0,0,0,0,0,0,0,0,0,0,0,0,0,0,0,0,0,0,0,0
2018-19,Arunachal Pradesh,Leparada,0,0,0,0,0,0,0,0,0,0,0,0,0,0,0,0,0,0,0,0,0,0,0,0,0,0,0,0,0,0,0,0
2018-19,Arunachal Pradesh,Shiyomi,0,0,0,0,0,0,0,0,0,0,0,0,0,0,0,0,0,0,0,0,0,0,0,0,0,0,0,0,0,0,0,0
2018-19,Arunachal Pradesh,Pakkessang,0,0,0,0,0,0,0,0,0,0,0,0,0,0,0,0,0,0,0,0,0,0,0,0,0,0,0,0,0,0,0,0
2018-19,Arunachal Pradesh,Total,15,0,3,7,4,1,0,0,43,0,17,17,9,0,0,0,0,0,0,0,0,0,0,0,58,0,20,24,13,1,0,0
2018-19,Assam,BIEO,0,0,0,0,0,0,0,0,0,0,0,0,0,0,0,0,0,0,0,0,0,0,0,0,0,0,0,0,0,0,0,0
2018-19,Assam,Barpeta,12,0,0,4,5,2,1,0,16,0,0,3,7,6,0,0,0,0,0,0,0,0,0,0,28,0,0,7,12,8,1,0
2018-19,Assam,Baksa,51,0,11,6,13,14,5,2,190,0,5,28,116,33,7,1,0,0,0,0,0,0,0,0,241,0,16,34,129,47,12,3
2018-19,Assam,Bongaigaon,56,0,12,12,14,11,4,3,220,2,6,62,84,64,2,0,0,0,0,0,0,0,0,0,276,2,18,74,98,75,6,3
2018-19,Assam,CID,0,0,0,0,0,0,0,0,0,0,0,0,0,0,0,0,0,0,0,0,0,0,0,0,0,0,0,0,0,0,0,0
2018-19,Assam,Cachar,507,3,15,185,255,35,14,0,203,2,18,22,135,25,1,0,0,0,0,0,0,0,0,0,710,5,33,207,390,60,15,0
2018-19,Assam,Chirang,22,0,2,1,7,7,5,0,73,1,2,6,47,17,0,0,0,0,0,0,0,0,0,0,95,1,4,7,54,24,5,0
2018-19,Assam,Darrang,24,0,0,2,12,8,2,0,60,0,0,6,32,22,0,0,0,0,0,0,0,0,0,0,84,0,0,8,44,30,2,0
2018-19,Assam,Dhemaji,189,0,12,20,109,44,2,2,110,0,4,6,65,24,11,0,0,0,0,0,0,0,0,0,299,0,16,26,174,68,13,2
2018-19,Assam,Dhubri,75,1,4,12,24,17,9,8,250,4,4,94,93,48,6,1,0,0,0,0,0,0,0,0,325,5,8,106,117,65,15,9
2018-19,Assam,Dibrugarh,2,0,2,0,0,0,0,0,10,0,6,4,0,0,0,0,0,0,0,0,0,0,0,0,12,0,8,4,0,0,0,0
2018-19,Assam,GRP,0,0,0,0,0,0,0,0,0,0,0,0,0,0,0,0,0,0,0,0,0,0,0,0,0,0,0,0,0,0,0,0
2018-19,Assam,Goalpara,0,0,0,0,0,0,0,0,0,0,0,0,0,0,0,0,0,0,0,0,0,0,0,0,0,0,0,0,0,0,0,0
2018-19,Assam,Golaghat,25,0,0,0,0,25,0,0,52,0,0,0,0,52,0,0,0,0,0,0,0,0,0,0,77,0,0,0,0,77,0,0
2018-19,Assam,Guwahati City,539,0,26,59,142,182,98,32,742,2,22,74,381,214,43,6,0,0,0,0,0,0,0,0,1281,2,48,133,523,396,141,38
2018-19,Assam,Hailakandi,34,0,5,6,8,15,0,0,167,0,3,40,55,69,0,0,0,0,0,0,0,0,0,0,201,0,8,46,63,84,0,0
2018-19,Assam,Hamren,0,0,0,0,0,0,0,0,0,0,0,0,0,0,0,0,0,0,0,0,0,0,0,0,0,0,0,0,0,0,0,0
2018-19,Assam,Jorhat,29,0,20,9,0,0,0,0,10,2,2,6,0,0,0,0,0,0,0,0,0,0,0,0,39,2,22,15,0,0,0,0
2018-19,Assam,Kamrup,108,1,1,11,52,28,11,4,243,0,4,20,156,45,15,3,0,0,0,0,0,0,0,0,351,1,5,31,208,73,26,7
2018-19,Assam,Karbi Anglong,0,0,0,0,0,0,0,0,0,0,0,0,0,0,0,0,0,0,0,0,0,0,0,0,0,0,0,0,0,0,0,0
2018-19,Assam,Karimganj,0,0,0,0,0,0,0,0,0,0,0,0,0,0,0,0,0,0,0,0,0,0,0,0,0,0,0,0,0,0,0,0
2018-19,Assam,Kokrajhar,0,0,0,0,0,0,0,0,0,0,0,0,0,0,0,0,0,0,0,0,0,0,0,0,0,0,0,0,0,0,0,0
2018-19,Assam,Lakhimpur,76,0,9,10,32,15,9,1,100,2,5,67,19,5,2,0,0,0,0,0,0,0,0,0,176,2,14,77,51,20,11,1
2018-19,Assam,Morigaon,0,0,0,0,0,0,0,0,100,0,0,0,100,0,0,0,0,0,0,0,0,0,0,0,100,0,0,0,100,0,0,0
2018-19,Assam,Dima Hasao,11,0,2,0,3,4,1,1,29,0,0,4,19,5,1,0,0,0,0,0,0,0,0,0,40,0,2,4,22,9,2,1
2018-19,Assam,Nagaon,0,0,0,0,0,0,0,0,0,0,0,0,0,0,0,0,0,0,0,0,0,0,0,0,0,0,0,0,0,0,0,0
2018-19,Assam,Nalbari,0,0,0,0,0,0,0,0,0,0,0,0,0,0,0,0,0,0,0,0,0,0,0,0,0,0,0,0,0,0,0,0
2018-19,Assam,RPO,0,0,0,0,0,0,0,0,0,0,0,0,0,0,0,0,0,0,0,0,0,0,0,0,0,0,0,0,0,0,0,0
2018-19,Assam,SOU,0,0,0,0,0,0,0,0,0,0,0,0,0,0,0,0,0,0,0,0,0,0,0,0,0,0,0,0,0,0,0,0
2018-19,Assam,STF,0,0,0,0,0,0,0,0,0,0,0,0,0,0,0,0,0,0,0,0,0,0,0,0,0,0,0,0,0,0,0,0
2018-19,Assam,Sibsagar,13,0,5,4,4,0,0,0,19,0,5,8,6,0,0,0,0,0,0,0,0,0,0,0,32,0,10,12,10,0,0,0
2018-19,Assam,Sonitpur,30,0,8,14,2,6,0,0,288,2,13,157,80,32,3,1,0,0,0,0,0,0,0,0,318,2,21,171,82,38,3,1
2018-19,Assam,Tinsukia,40,0,2,10,0,23,4,1,88,0,0,5,21,56,6,0,0,0,0,0,0,0,0,0,128,0,2,15,21,79,10,1
2018-19,Assam,Udalguri,0,0,0,0,0,0,0,0,0,0,0,0,0,0,0,0,0,0,0,0,0,0,0,0,0,0,0,0,0,0,0,0
2018-19,Assam,Sadia,8,0,0,0,2,3,3,0,27,0,0,2,15,9,1,0,0,0,0,0,0,0,0,0,35,0,0,2,17,12,4,0
2018-19,Assam,Majuli,5,0,0,0,4,1,0,0,7,0,0,0,6,1,0,0,0,0,0,0,0,0,0,0,12,0,0,0,10,2,0,0
2018-19,Assam,Biswanath,0,0,0,0,0,0,0,0,0,0,0,0,0,0,0,0,0,0,0,0,0,0,0,0,0,0,0,0,0,0,0,0
2018-19,Assam,Hojai,94,0,18,18,22,17,10,9,232,0,27,74,79,46,6,0,0,0,0,0,0,0,0,0,326,0,45,92,101,63,16,9
2018-19,Assam,South Salmara,15,0,6,0,3,4,2,0,49,0,1,12,28,8,0,0,0,0,0,0,0,0,0,0,64,0,7,12,31,12,2,0
2018-19,Assam,Charaideo,16,0,3,2,1,5,3,2,45,0,1,12,11,19,2,0,0,0,0,0,0,0,0,0,61,0,4,14,12,24,5,2
2018-19,Assam,Total,1981,5,163,385,714,466,183,65,3330,17,128,712,1555,800,106,12,0,0,0,0,0,0,0,0,5311,22,291,1097,2269,1266,289,77
2018-19,Bihar,Araria,37,2,4,10,13,6,1,1,178,0,14,102,32,28,1,1,0,0,0,0,0,0,0,0,215,2,18,112,45,34,2,2
2018-19,Bihar,Arwal,6,0,3,2,0,1,0,0,39,1,6,18,10,4,0,0,0,0,0,0,0,0,0,0,45,1,9,20,10,5,0,0
2018-19,Bihar,Aurangabad,37,0,7,16,8,6,0,0,52,0,2,26,21,2,1,0,0,0,0,0,0,0,0,0,89,0,9,42,29,8,1,0
2018-19,Bihar,Bagaha,10,1,4,2,2,1,0,0,85,0,12,54,8,11,0,0,0,0,0,0,0,0,0,0,95,1,16,56,10,12,0,0
2018-19,Bihar,Banka,32,2,8,12,5,2,2,1,181,1,24,94,46,12,3,1,0,0,0,0,0,0,0,0,213,3,32,106,51,14,5,2
2018-19,Bihar,Begusarai,17,0,9,3,1,4,0,0,136,0,48,81,7,0,0,0,0,0,0,0,0,0,0,0,153,0,57,84,8,4,0,0
2018-19,Bihar,Bettiah,185,0,51,98,31,5,0,0,16,0,8,5,0,2,1,0,0,0,0,0,0,0,0,0,201,0,59,103,31,7,1,0
2018-19,Bihar,Bhabhua,35,1,4,16,10,2,2,0,129,0,21,74,26,7,1,0,0,0,0,0,0,0,0,0,164,1,25,90,36,9,3,0
2018-19,Bihar,Bhagalpur,65,1,17,18,10,12,7,0,323,1,42,181,71,24,3,1,0,0,0,0,0,0,0,0,388,2,59,199,81,36,10,1
2018-19,Bihar,Bhojpur,41,4,9,13,4,4,2,5,169,1,40,83,32,11,1,1,0,0,0,0,0,0,0,0,210,5,49,96,36,15,3,6
2018-19,Bihar,Buxar,36,2,16,7,2,4,3,2,139,1,17,67,32,19,2,1,0,0,0,0,0,0,0,0,175,3,33,74,34,23,5,3
2018-19,Bihar,Darbhanga,32,6,15,5,6,0,0,0,210,4,30,130,42,4,0,0,0,0,0,0,0,0,0,0,242,10,45,135,48,4,0,0
2018-19,Bihar,Gaya,117,9,36,30,21,15,5,1,348,6,47,196,72,20,6,1,0,0,0,0,0,0,0,0,465,15,83,226,93,35,11,2
2018-19,Bihar,Gopalganj,28,1,7,5,5,5,4,1,153,0,25,95,20,13,0,0,0,0,0,0,0,0,0,0,181,1,32,100,25,18,4,1
2018-19,Bihar,Jamalpur Railway,4,0,1,3,0,0,0,0,0,0,0,0,0,0,0,0,0,0,0,0,0,0,0,0,4,0,1,3,0,0,0,0
2018-19,Bihar,Jamui,33,0,10,9,2,9,2,1,110,0,29,56,17,8,0,0,0,0,0,0,0,0,0,0,143,0,39,65,19,17,2,1
2018-19,Bihar,Jehanabad,32,0,10,7,9,3,2,1,94,0,22,53,16,1,2,0,0,0,0,0,0,0,0,0,126,0,32,60,25,4,4,1
2018-19,Bihar,Katihar,31,1,7,7,4,9,2,1,234,3,24,140,60,5,2,0,0,0,0,0,0,0,0,0,265,4,31,147,64,14,4,1
2018-19,Bihar,Katihar Railway,4,1,0,1,1,0,1,0,1,0,0,0,0,0,0,1,0,0,0,0,0,0,0,0,5,1,0,1,1,0,1,1
2018-19,Bihar,Khagaria,34,3,14,7,4,3,3,0,157,1,21,80,37,18,0,0,0,0,0,0,0,0,0,0,191,4,35,87,41,21,3,0
2018-19,Bihar,Kishanganj,11,0,1,2,3,5,0,0,71,0,10,31,20,10,0,0,0,0,0,0,0,0,0,0,82,0,11,33,23,15,0,0
2018-19,Bihar,Lakhisarai,24,0,10,6,3,2,2,1,72,15,38,12,6,0,1,0,0,0,0,0,0,0,0,0,96,15,48,18,9,2,3,1
2018-19,Bihar,Madhepura,43,0,14,14,5,7,3,0,177,1,20,92,38,24,2,0,0,0,0,0,0,0,0,0,220,1,34,106,43,31,5,0
2018-19,Bihar,Madhubani,5,0,3,0,2,0,0,0,22,0,4,15,2,1,0,0,0,0,0,0,0,0,0,0,27,0,7,15,4,1,0,0
2018-19,Bihar,Motihari,63,3,25,15,5,8,4,3,421,4,83,229,71,33,1,0,0,0,0,0,0,0,0,0,484,7,108,244,76,41,5,3
2018-19,Bihar,Munger,51,2,15,11,15,5,2,1,186,2,32,98,44,10,0,0,0,0,0,0,0,0,0,0,237,4,47,109,59,15,2,1
2018-19,Bihar,Muzaffarpur,149,19,30,35,29,20,9,7,619,8,69,301,193,46,2,0,0,0,0,0,0,0,0,0,768,27,99,336,222,66,11,7
2018-19,Bihar,Muzaffarpur Railway,0,0,0,0,0,0,0,0,2,0,0,2,0,0,0,0,0,0,0,0,0,0,0,0,2,0,0,2,0,0,0,0
2018-19,Bihar,Nalanda,119,2,52,23,14,16,7,5,346,0,53,191,70,24,6,2,0,0,0,0,0,0,0,0,465,2,105,214,84,40,13,7
2018-19,Bihar,Naugachia,17,0,9,0,8,0,0,0,87,0,10,64,13,0,0,0,0,0,0,0,0,0,0,0,104,0,19,64,21,0,0,0
2018-19,Bihar,Nawadah,66,6,3,33,20,4,0,0,199,2,36,99,56,6,0,0,0,0,0,0,0,0,0,0,265,8,39,132,76,10,0,0
2018-19,Bihar,Patna,329,11,87,81,56,59,26,9,1061,4,177,508,273,82,12,5,0,0,0,0,0,0,0,0,1390,15,264,589,329,141,38,14
2018-19,Bihar,Patna Railway,7,1,0,0,1,3,0,2,16,2,0,0,11,1,2,0,0,0,0,0,0,0,0,0,23,3,0,0,12,4,2,2
2018-19,Bihar,Purnea,59,0,22,16,13,7,1,0,227,0,37,124,59,5,2,0,0,0,0,0,0,0,0,0,286,0,59,140,72,12,3,0
2018-19,Bihar,Rohtas,70,2,16,18,16,12,5,1,246,3,45,121,62,13,0,2,0,0,0,0,0,0,0,0,316,5,61,139,78,25,5,3
2018-19,Bihar,Saharsa,29,0,4,6,9,6,4,0,112,0,14,47,31,18,2,0,0,0,0,0,0,0,0,0,141,0,18,53,40,24,6,0
2018-19,Bihar,Samastipur,48,4,15,7,5,9,8,0,290,0,31,169,62,26,1,1,0,0,0,0,0,0,0,0,338,4,46,176,67,35,9,1
2018-19,Bihar,Saran,112,4,30,21,24,16,15,2,438,2,80,208,106,35,6,1,0,0,0,0,0,0,0,0,550,6,110,229,130,51,21,3
2018-19,Bihar,Sheikhpura,11,0,0,3,4,3,1,0,40,0,13,12,8,6,1,0,0,0,0,0,0,0,0,0,51,0,13,15,12,9,2,0
2018-19,Bihar,Sheohar,8,0,1,3,3,1,0,0,43,0,7,29,6,1,0,0,0,0,0,0,0,0,0,0,51,0,8,32,9,2,0,0
2018-19,Bihar,Sitamarhi,66,7,25,15,14,2,2,1,328,2,47,196,63,17,2,1,0,0,0,0,0,0,0,0,394,9,72,211,77,19,4,2
2018-19,Bihar,Siwan,41,3,21,10,3,1,3,0,214,1,46,127,36,3,1,0,0,0,0,0,0,0,0,0,255,4,67,137,39,4,4,0
2018-19,Bihar,Supaul,16,0,3,6,5,1,0,1,152,2,33,75,33,8,1,0,0,0,0,0,0,0,0,0,168,2,36,81,38,9,1,1
2018-19,Bihar,Vaishali,79,14,21,17,17,5,3,2,330,17,26,223,39,23,2,0,0,0,0,0,0,0,0,0,409,31,47,240,56,28,5,2
2018-19,Bihar,Economic Offences Unit,0,0,0,0,0,0,0,0,0,0,0,0,0,0,0,0,0,0,0,0,0,0,0,0,0,0,0,0,0,0,0,0
2018-19,Bihar,Anti Terrorist Squad,0,0,0,0,0,0,0,0,0,0,0,0,0,0,0,0,0,0,0,0,0,0,0,0,0,0,0,0,0,0,0,0
2018-19,Bihar,Total,2239,112,639,613,412,283,131,49,8453,84,1343,4508,1851,581,67,19,0,0,0,0,0,0,0,0,10692,196,1982,5121,2263,864,198,68
2018-19,Chhattisgarh,Balod,95,0,3,8,48,18,9,9,382,1,6,70,253,43,6,3,0,0,0,0,0,0,0,0,477,1,9,78,301,61,15,12
2018-19,Chhattisgarh,Balodbazar,147,0,5,16,70,28,15,13,688,0,8,151,438,79,8,4,0,0,0,0,0,0,0,0,835,0,13,167,508,107,23,17
2018-19,Chhattisgarh,Balrampur,43,0,2,6,14,16,3,2,150,1,4,41,74,27,2,1,0,0,0,0,0,0,0,0,193,1,6,47,88,43,5,3
2018-19,Chhattisgarh,Bemetra,72,2,1,7,42,12,6,2,293,0,4,73,193,19,2,2,0,0,0,0,0,0,0,0,365,2,5,80,235,31,8,4
2018-19,Chhattisgarh,Bilaspur,317,1,16,29,98,102,42,29,1075,1,62,273,474,227,29,9,0,0,0,0,0,0,0,0,1392,2,78,302,572,329,71,38
2018-19,Chhattisgarh,Bizapur,15,0,2,2,7,4,0,0,40,0,1,9,25,4,0,1,0,0,0,0,0,0,0,0,55,0,3,11,32,8,0,1
2018-19,Chhattisgarh,Dantewara,29,0,4,4,10,6,3,2,46,0,4,4,34,3,0,1,0,0,0,0,0,0,0,0,75,0,8,8,44,9,3,3
2018-19,Chhattisgarh,Dhamtari,115,0,4,9,54,21,15,12,340,0,2,50,235,45,3,5,0,0,0,0,0,0,0,0,455,0,6,59,289,66,18,17
2018-19,Chhattisgarh,Durg,461,1,21,40,196,103,70,30,1020,0,19,193,623,145,27,13,0,0,0,0,0,0,0,0,1481,1,40,233,819,248,97,43
2018-19,Chhattisgarh,Gariyaband,39,0,0,0,24,13,1,1,205,0,2,47,136,17,3,0,0,0,0,0,0,0,0,0,244,0,2,47,160,30,4,1
2018-19,Chhattisgarh,GRP Raipur,16,0,0,0,3,8,5,0,18,0,0,1,13,4,0,0,0,0,0,0,0,0,0,0,34,0,0,1,16,12,5,0
2018-19,Chhattisgarh,Jagdalpur,65,1,0,4,29,8,21,2,217,0,7,64,120,23,1,2,0,0,0,0,0,0,0,0,282,1,7,68,149,31,22,4
2018-19,Chhattisgarh,Janjgir,197,0,12,16,60,69,30,10,667,0,11,137,250,180,72,17,0,0,0,0,0,0,0,0,864,0,23,153,310,249,102,27
2018-19,Chhattisgarh,Jashpur,69,0,6,9,25,16,6,7,193,0,3,48,101,35,5,1,0,0,0,0,0,0,0,0,262,0,9,57,126,51,11,8
2018-19,Chhattisgarh,Kabirdham,97,0,4,13,44,19,11,6,288,0,3,69,166,38,12,0,0,0,0,0,0,0,0,0,385,0,7,82,210,57,23,6
2018-19,Chhattisgarh,Kanker,64,0,2,10,31,14,6,1,133,0,6,42,52,27,4,2,0,0,0,0,0,0,0,0,197,0,8,52,83,41,10,3
2018-19,Chhattisgarh,Kondagaon,30,0,1,0,13,10,6,0,100,0,2,13,66,14,4,1,0,0,0,0,0,0,0,0,130,0,3,13,79,24,10,1
2018-19,Chhattisgarh,Korba,172,0,10,22,43,65,26,6,462,0,6,106,201,123,22,4,0,0,0,0,0,0,0,0,634,0,16,128,244,188,48,10
2018-19,Chhattisgarh,Koriya,95,0,0,9,22,34,28,2,309,0,21,42,143,52,38,13,0,0,0,0,0,0,0,0,404,0,21,51,165,86,66,15
2018-19,Chhattisgarh,Mahasamund,109,0,1,16,36,30,21,5,374,1,3,53,213,93,7,4,0,0,0,0,0,0,0,0,483,1,4,69,249,123,28,9
2018-19,Chhattisgarh,Mungali,79,1,7,6,34,13,9,9,274,0,3,84,156,25,4,2,0,0,0,0,0,0,0,0,353,1,10,90,190,38,13,11
2018-19,Chhattisgarh,Narayanpur,7,0,1,1,1,1,3,0,33,0,3,10,18,2,0,0,0,0,0,0,0,0,0,0,40,0,4,11,19,3,3,0
2018-19,Chhattisgarh,Raigarh,242,1,18,20,63,84,39,17,736,1,23,152,353,170,29,8,0,0,0,0,0,0,0,0,978,2,41,172,416,254,68,25
2018-19,Chhattisgarh,Raipur,794,0,46,64,210,266,140,68,1792,0,29,356,853,445,80,29,0,0,0,0,0,0,0,0,2586,0,75,420,1063,711,220,97
2018-19,Chhattisgarh,Rajnandgaon,248,0,11,10,117,55,35,20,723,2,6,118,491,82,19,5,0,0,0,0,0,0,0,0,971,2,17,128,608,137,54,25
2018-19,Chhattisgarh,Sarguja,100,0,3,14,17,43,18,5,318,0,14,71,118,83,23,9,0,0,0,0,0,0,0,0,418,0,17,85,135,126,41,14
2018-19,Chhattisgarh,Sukma,13,0,3,3,4,1,2,0,31,0,0,10,17,3,1,0,0,0,0,0,0,0,0,0,44,0,3,13,21,4,3,0
2018-19,Chhattisgarh,Surajpur,62,0,1,8,22,16,10,5,201,0,3,57,119,18,3,1,0,0,0,0,0,0,0,0,263,0,4,65,141,34,13,6
2018-19,Chhattisgarh,Total,3792,7,184,346,1337,1075,580,263,11108,7,255,2344,5935,2026,404,137,0,0,0,0,0,0,0,0,14900,14,439,2690,7272,3101,984,400
2018-19,Goa,North Goa,151,1,1,1,45,54,32,17,131,4,3,0,88,22,8,6,0,0,0,0,0,0,0,0,282,5,4,1,133,76,40,23
2018-19,Goa,South Goa,161,1,2,1,50,49,42,16,164,2,1,14,106,26,8,7,0,0,0,0,0,0,0,0,325,3,3,15,156,75,50,23
2018-19,Goa,CID,6,0,0,0,2,2,1,1,2,0,0,0,2,0,0,0,0,0,0,0,0,0,0,0,8,0,0,0,4,2,1,1
2018-19,Goa,Total,318,2,3,2,97,105,75,34,297,6,4,14,196,48,16,13,0,0,0,0,0,0,0,0,615,8,7,16,293,153,91,47
2018-19,Gujarat,Ahmedabad City,1065,6,26,52,456,342,129,54,2149,4,40,281,1501,258,40,25,21,0,0,0,16,5,0,0,3235,10,66,333,1973,605,169,79
2018-19,Gujarat,Ahmedabad Rural,79,3,1,0,26,31,12,6,98,5,1,0,72,17,2,1,0,0,0,0,0,0,0,0,177,8,2,0,98,48,14,7
2018-19,Gujarat,Amreli,23,0,0,0,8,11,3,1,146,0,0,0,130,16,0,0,0,0,0,0,0,0,0,0,169,0,0,0,138,27,3,1
2018-19,Gujarat,Anand,146,0,0,0,64,46,33,3,345,0,0,0,169,127,43,6,0,0,0,0,0,0,0,0,491,0,0,0,233,173,76,9
2018-19,Gujarat,Arvalli,35,0,0,0,12,21,2,0,85,0,0,0,52,32,1,0,0,0,0,0,0,0,0,0,120,0,0,0,64,53,3,0
2018-19,Gujarat,Banaskantha,103,0,0,1,56,28,15,3,214,0,0,2,192,19,0,1,0,0,0,0,0,0,0,0,317,0,0,3,248,47,15,4
2018-19,Gujarat,Bharuch,122,10,8,0,42,32,20,10,230,5,10,1,178,29,5,2,0,0,0,0,0,0,0,0,352,15,18,1,220,61,25,12
2018-19,Gujarat,Bhavnagar,64,1,0,0,32,24,2,5,187,0,0,21,126,40,0,0,0,0,0,0,0,0,0,0,251,1,0,21,158,64,2,5
2018-19,Gujarat,Botad,15,0,0,5,6,3,1,0,37,0,1,14,20,2,0,0,0,0,0,0,0,0,0,0,52,0,1,19,26,5,1,0
2018-19,Gujarat,Chhotaudepur,15,0,2,0,5,3,4,1,16,1,0,0,10,2,1,2,0,0,0,0,0,0,0,0,31,1,2,0,15,5,5,3
2018-19,Gujarat,CID Crime,0,0,0,0,0,0,0,0,0,0,0,0,0,0,0,0,0,0,0,0,0,0,0,0,0,0,0,0,0,0,0,0
2018-19,Gujarat,Dahod,18,0,3,1,14,0,0,0,146,0,9,92,44,0,1,0,0,0,0,0,0,0,0,0,164,0,12,93,58,0,1,0
2018-19,Gujarat,Dang,0,0,0,0,0,0,0,0,0,0,0,0,0,0,0,0,0,0,0,0,0,0,0,0,0,0,0,0,0,0,0,0
2018-19,Gujarat,Devbhumi Dwarka,26,0,1,0,12,7,3,3,80,0,3,15,51,8,1,2,0,0,0,0,0,0,0,0,106,0,4,15,63,15,4,5
2018-19,Gujarat,Gandhinagar,156,4,11,1,67,44,22,7,299,5,5,0,251,27,7,4,0,0,0,0,0,0,0,0,455,9,16,1,318,71,29,11
2018-19,Gujarat,Gir Somnath,18,2,0,0,5,6,4,1,76,0,10,28,32,3,1,2,0,0,0,0,0,0,0,0,94,2,10,28,37,9,5,3
2018-19,Gujarat,Jamnagar,84,5,3,0,52,19,5,0,170,7,0,1,85,65,12,0,0,0,0,0,0,0,0,0,254,12,3,1,137,84,17,0
2018-19,Gujarat,Junagadh,36,0,3,1,6,16,9,1,93,1,7,61,16,7,0,1,0,0,0,0,0,0,0,0,129,1,10,62,22,23,9,2
2018-19,Gujarat,Kachchh East(G),166,0,0,0,107,23,28,8,83,0,0,1,41,29,8,4,0,0,0,0,0,0,0,0,249,0,0,1,148,52,36,12
2018-19,Gujarat,Kachchh West(B),72,0,3,3,35,25,4,2,177,0,4,16,133,21,2,1,0,0,0,0,0,0,0,0,249,0,7,19,168,46,6,3
2018-19,Gujarat,Kheda,63,3,1,1,26,16,12,4,125,0,1,4,85,29,5,1,0,0,0,0,0,0,0,0,188,3,2,5,111,45,17,5
2018-19,Gujarat,Mahisagar,20,0,2,0,9,6,1,2,36,2,0,1,23,9,1,0,0,0,0,0,0,0,0,0,56,2,2,1,32,15,2,2
2018-19,Gujarat,Mehsana,147,0,0,0,71,37,25,14,453,0,1,5,372,64,8,3,0,0,0,0,0,0,0,0,600,0,1,5,443,101,33,17
2018-19,Gujarat,Morbi,22,0,0,0,7,9,5,1,90,0,0,0,45,36,7,2,0,0,0,0,0,0,0,0,112,0,0,0,52,45,12,3
2018-19,Gujarat,Narmada,11,0,0,0,5,4,2,0,11,0,0,0,7,4,0,0,0,0,0,0,0,0,0,0,22,0,0,0,12,8,2,0
2018-19,Gujarat,Navsari,82,2,1,0,12,31,23,13,128,1,3,0,68,39,10,7,0,0,0,0,0,0,0,0,210,3,4,0,80,70,33,20
2018-19,Gujarat,Panchmahal,69,2,2,0,35,18,8,4,89,4,1,0,67,13,2,2,0,0,0,0,0,0,0,0,158,6,3,0,102,31,10,6
2018-19,Gujarat,Patan,55,2,0,0,32,15,3,3,179,1,0,1,146,29,2,0,0,0,0,0,0,0,0,0,234,3,0,1,178,44,5,3
2018-19,Gujarat,Porbandar,23,2,1,0,7,9,2,2,45,1,2,0,34,7,1,0,0,0,0,0,0,0,0,0,68,3,3,0,41,16,3,2
2018-19,Gujarat,Rajkot City,262,0,0,0,87,119,44,12,414,0,0,0,207,161,37,9,0,0,0,0,0,0,0,0,676,0,0,0,294,280,81,21
2018-19,Gujarat,Rajkot Rural,91,12,7,3,34,20,8,7,256,4,3,1,213,30,4,1,0,0,0,0,0,0,0,0,347,16,10,4,247,50,12,8
2018-19,Gujarat,Sabarkantha,66,1,1,1,33,16,9,5,168,0,0,23,125,17,2,1,0,0,0,0,0,0,0,0,234,1,1,24,158,33,11,6
2018-19,Gujarat,Surat City,1225,61,65,26,441,363,209,60,1797,47,73,84,1024,387,156,26,0,0,0,0,0,0,0,0,3022,108,138,110,1465,750,365,86
2018-19,Gujarat,Surat Rural,95,4,5,0,34,38,11,3,100,4,5,0,71,17,2,1,0,0,0,0,0,0,0,0,195,8,10,0,105,55,13,4
2018-19,Gujarat,Surendranagar,27,0,0,0,11,9,4,3,45,0,0,0,38,4,3,0,0,0,0,0,0,0,0,0,72,0,0,0,49,13,7,3
2018-19,Gujarat,Tapi,25,3,0,0,7,7,3,5,31,3,1,0,15,10,0,2,0,0,0,0,0,0,0,0,56,6,1,0,22,17,3,7
2018-19,Gujarat,Vadodara City,321,0,10,13,74,101,86,37,481,0,8,98,228,110,27,10,0,0,0,0,0,0,0,0,802,0,18,111,302,211,113,47
2018-19,Gujarat,Vadodara Rural,43,0,0,0,20,11,12,0,47,0,0,0,35,10,1,1,0,0,0,0,0,0,0,0,90,0,0,0,55,21,13,1
2018-19,Gujarat,Valsad,91,7,1,0,28,25,16,14,122,5,3,1,84,18,6,5,0,0,0,0,0,0,0,0,213,12,4,1,112,43,22,19
2018-19,Gujarat,W.Rly Ahmedabad,5,0,0,0,3,1,1,0,6,0,0,0,4,1,1,0,0,0,0,0,0,0,0,0,11,0,0,0,7,2,2,0
2018-19,Gujarat,W.Rly Vadodara,17,0,0,0,7,1,4,5,14,2,0,0,8,2,2,0,0,0,0,0,0,0,0,0,31,2,0,0,15,3,6,5
2018-19,Gujarat,Total,5003,130,157,108,1988,1537,784,299,9268,102,191,751,6002,1699,401,122,21,0,0,0,16,5,0,0,14292,232,348,859,8006,3241,1185,421
2018-19,Haryana,Ambala,242,0,2,20,110,70,40,0,200,0,1,18,90,51,40,0,0,0,0,0,0,0,0,0,442,0,3,38,200,121,80,0
2018-19,Haryana,Bhiwani,152,12,22,15,30,36,28,9,316,15,5,35,166,84,9,2,0,0,0,0,0,0,0,0,468,27,27,50,196,120,37,11
2018-19,Haryana,Faridabad,520,21,39,36,252,102,46,24,771,14,34,40,550,110,15,8,0,0,0,0,0,0,0,0,1291,35,73,76,802,212,61,32
2018-19,Haryana,Fatehabad,141,18,15,5,36,40,17,10,362,22,16,18,188,103,13,2,0,0,0,0,0,0,0,0,503,40,31,23,224,143,30,12
2018-19,Haryana,GRP,39,2,4,0,9,13,7,4,24,1,3,0,16,4,0,0,0,0,0,0,0,0,0,0,63,3,7,0,25,17,7,4
2018-19,Haryana,Gurugram,230,1,15,32,67,65,40,10,399,2,26,129,166,63,9,4,0,0,0,0,0,0,0,0,629,3,41,161,233,128,49,14
2018-19,Haryana,Hissar,135,0,1,16,52,36,21,9,331,0,2,44,243,40,1,1,0,0,0,0,0,0,0,0,466,0,3,60,295,76,22,10
2018-19,Haryana,Jhajjar,420,210,0,22,30,86,66,6,536,268,0,20,17,156,64,11,0,0,0,0,0,0,0,0,956,478,0,42,47,242,130,17
2018-19,Haryana,Jind,142,0,6,19,52,42,17,6,395,1,9,58,209,87,23,8,0,0,0,0,0,0,0,0,537,1,15,77,261,129,40,14
2018-19,Haryana,Kaithal,130,5,11,18,31,34,25,6,146,8,11,6,77,35,7,2,0,0,0,0,0,0,0,0,276,13,22,24,108,69,32,8
2018-19,Haryana,Karnal,106,0,11,16,28,24,20,7,96,0,1,15,36,31,10,3,0,0,0,0,0,0,0,0,202,0,12,31,64,55,30,10
2018-19,Haryana,Kurukshetra,212,2,2,3,151,48,5,1,309,2,3,21,222,52,7,2,0,0,0,0,0,0,0,0,521,4,5,24,373,100,12,3
2018-19,Haryana,Mahendergarh,90,0,7,15,29,18,20,1,193,1,7,54,111,17,3,0,0,0,0,0,0,0,0,0,283,1,14,69,140,35,23,1
2018-19,Haryana,Nuh,50,1,9,4,27,4,5,0,71,1,1,15,40,14,0,0,0,0,0,0,0,0,0,0,121,2,10,19,67,18,5,0
2018-19,Haryana,Palwal,131,3,16,31,38,29,8,6,228,5,13,52,125,28,5,0,0,0,0,0,0,0,0,0,359,8,29,83,163,57,13,6
2018-19,Haryana,Panchkula,176,9,32,17,69,34,13,2,366,5,36,63,187,62,12,1,0,0,0,0,0,0,0,0,542,14,68,80,256,96,25,3
2018-19,Haryana,Panipat,451,17,43,55,122,124,69,21,775,15,40,204,348,140,26,2,0,0,0,0,0,0,0,0,1226,32,83,259,470,264,95,23
2018-19,Haryana,Rewari,182,6,16,20,66,37,24,13,360,5,10,59,228,51,3,4,0,0,0,0,0,0,0,0,542,11,26,79,294,88,27,17
2018-19,Haryana,Rohtak,318,0,20,34,122,91,41,10,428,1,6,49,278,84,5,5,0,0,0,0,0,0,0,0,746,1,26,83,400,175,46,15
2018-19,Haryana,Sirsa,126,0,7,12,51,36,13,7,374,0,11,58,240,59,5,1,0,0,0,0,0,0,0,0,500,0,18,70,291,95,18,8
2018-19,Haryana,Sonipat,242,2,13,46,52,64,54,11,424,1,7,57,170,167,20,2,0,0,0,0,0,0,0,0,666,3,20,103,222,231,74,13
2018-19,Haryana,Yamunanagar,228,10,14,22,83,60,30,9,333,6,16,47,190,59,8,7,0,0,0,0,0,0,0,0,561,16,30,69,273,119,38,16
2018-19,Haryana,Irrigation & Power,0,0,0,0,0,0,0,0,0,0,0,0,0,0,0,0,0,0,0,0,0,0,0,0,0,0,0,0,0,0,0,0
2018-19,Haryana,Charkhi Dadri,45,0,2,2,17,14,8,2,96,0,0,5,71,20,0,0,0,0,0,0,0,0,0,0,141,0,2,7,88,34,8,2
2018-19,Haryana,Hansi,48,0,2,11,17,8,6,4,126,0,1,17,92,10,5,1,0,0,0,0,0,0,0,0,174,0,3,28,109,18,11,5
2018-19,Haryana,Total,4556,319,309,471,1541,1115,623,178,7659,373,259,1084,4060,1527,290,66,0,0,0,0,0,0,0,0,12215,692,568,1555,5601,2642,913,244
2018-19,Himachal Pradesh,Baddi,66,0,1,1,27,20,11,6,152,1,8,9,114,17,1,2,0,0,0,0,0,0,0,0,218,1,9,10,141,37,12,8
2018-19,Himachal Pradesh,Bilaspur,36,0,1,4,18,8,4,1,133,0,0,22,89,17,2,3,0,0,0,0,0,0,0,0,169,0,1,26,107,25,6,4
2018-19,Himachal Pradesh,Chamba,38,0,1,2,16,9,9,1,77,0,0,15,54,6,2,0,0,0,0,0,0,0,0,0,115,0,1,17,70,15,11,1
2018-19,Himachal Pradesh,CID,0,0,0,0,0,0,0,0,0,0,0,0,0,0,0,0,0,0,0,0,0,0,0,0,0,0,0,0,0,0,0,0
2018-19,Himachal Pradesh,GRP,0,0,0,0,0,0,0,0,0,0,0,0,0,0,0,0,0,0,0,0,0,0,0,0,0,0,0,0,0,0,0,0
2018-19,Himachal Pradesh,Hamirpur,34,0,2,6,11,8,6,1,80,0,1,6,56,16,0,1,0,0,0,0,0,0,0,0,114,0,3,12,67,24,6,2
2018-19,Himachal Pradesh,Kangra,92,0,1,7,28,27,18,11,214,0,0,16,151,37,10,0,0,0,0,0,0,0,0,0,306,0,1,23,179,64,28,11
2018-19,Himachal Pradesh,Kinnaur,24,0,1,6,6,6,3,2,17,0,1,2,13,0,1,0,0,0,0,0,0,0,0,0,41,0,2,8,19,6,4,2
2018-19,Himachal Pradesh,Kullu,123,2,3,8,23,48,24,15,107,0,0,12,39,53,3,0,0,0,0,0,0,0,0,0,230,2,3,20,62,101,27,15
2018-19,Himachal Pradesh,Lahaul & Spiti,3,0,0,0,1,1,1,0,5,0,1,0,1,2,0,1,0,0,0,0,0,0,0,0,8,0,1,0,2,3,1,1
2018-19,Himachal Pradesh,Mandi,95,0,3,13,33,22,16,8,253,0,0,59,151,37,2,4,0,0,0,0,0,0,0,0,348,0,3,72,184,59,18,12
2018-19,Himachal Pradesh,Shimla,37,0,17,19,1,0,0,0,62,0,9,45,7,0,0,1,0,0,0,0,0,0,0,0,99,0,26,64,8,0,0,1
2018-19,Himachal Pradesh,Sirmaur,44,2,3,4,15,12,4,4,99,4,2,5,70,16,1,1,0,0,0,0,0,0,0,0,143,6,5,9,85,28,5,5
2018-19,Himachal Pradesh,Solan,50,0,4,7,12,16,7,4,101,0,1,32,55,11,2,0,0,0,0,0,0,0,0,0,151,0,5,39,67,27,9,4
2018-19,Himachal Pradesh,Una,37,0,4,3,15,9,4,2,56,0,2,15,32,1,2,4,0,0,0,0,0,0,0,0,93,0,6,18,47,10,6,6
2018-19,Himachal Pradesh,Cyber,0,0,0,0,0,0,0,0,0,0,0,0,0,0,0,0,0,0,0,0,0,0,0,0,0,0,0,0,0,0,0,0
2018-19,Himachal Pradesh,Total,679,4,41,80,206,186,107,55,1356,5,25,238,832,213,26,17,0,0,0,0,0,0,0,0,2035,9,66,318,1038,399,133,72
2018-19,Kashmir,Anantnag,27,0,0,0,21,4,2,0,55,0,1,25,19,8,2,0,0,0,0,0,0,0,0,0,82,0,1,25,40,12,4,0
2018-19,Kashmir,Awantipora,18,0,0,0,12,3,3,0,14,0,0,0,8,6,0,0,0,0,0,0,0,0,0,0,32,0,0,0,20,9,3,0
2018-19,Kashmir,Bandipora,33,0,1,7,17,6,0,2,27,1,0,2,18,6,0,0,0,0,0,0,0,0,0,0,60,1,1,9,35,12,0,2
2018-19,Kashmir,Baramulla,0,0,0,0,0,0,0,0,0,0,0,0,0,0,0,0,0,0,0,0,0,0,0,0,0,0,0,0,0,0,0,0
2018-19,Kashmir,Budgam,19,0,0,0,10,7,2,0,19,0,0,0,9,8,2,0,0,0,0,0,0,0,0,0,38,0,0,0,19,15,4,0
2018-19,Kashmir,Crime Jammu,0,0,0,0,0,0,0,0,0,0,0,0,0,0,0,0,0,0,0,0,0,0,0,0,0,0,0,0,0,0,0,0
2018-19,Kashmir,Crime Srinagar,0,0,0,0,0,0,0,0,0,0,0,0,0,0,0,0,0,0,0,0,0,0,0,0,0,0,0,0,0,0,0,0
2018-19,Kashmir,Doda,16,0,0,0,4,9,3,0,63,0,0,15,26,20,2,0,0,0,0,0,0,0,0,0,79,0,0,15,30,29,5,0
2018-19,Kashmir,Ganderbal,17,0,0,2,11,2,1,1,33,0,0,0,25,7,0,1,0,0,0,0,0,0,0,0,50,0,0,2,36,9,1,2
2018-19,Kashmir,Handwara,13,0,0,6,4,3,0,0,17,0,0,8,7,2,0,0,0,0,0,0,0,0,0,0,30,0,0,14,11,5,0,0
2018-19,Kashmir,Jammu,69,0,0,20,22,13,6,8,390,0,0,0,319,41,17,13,0,0,0,0,0,0,0,0,459,0,0,20,341,54,23,21
2018-19,Kashmir,Kargil,5,0,0,0,0,3,1,1,6,1,0,0,4,1,0,0,0,0,0,0,0,0,0,0,11,1,0,0,4,4,1,1
2018-19,Kashmir,Kathua,38,3,4,3,8,12,8,0,139,2,3,18,86,25,3,2,0,0,0,0,0,0,0,0,177,5,7,21,94,37,11,2
2018-19,Kashmir,Kishtwar,11,0,0,0,5,3,2,1,28,0,0,0,21,6,1,0,0,0,0,0,0,0,0,0,39,0,0,0,26,9,3,1
2018-19,Kashmir,Kulgam,27,0,0,1,25,1,0,0,10,0,0,0,7,3,0,0,0,0,0,0,0,0,0,0,37,0,0,1,32,4,0,0
2018-19,Kashmir,Kupwara,31,0,2,3,18,3,1,4,44,0,0,1,28,13,2,0,0,0,0,0,0,0,0,0,75,0,2,4,46,16,3,4
2018-19,Kashmir,Leh,10,0,0,0,5,3,2,0,10,0,0,0,3,7,0,0,0,0,0,0,0,0,0,0,20,0,0,0,8,10,2,0
2018-19,Kashmir,Poonch,13,0,0,1,5,4,2,1,58,0,1,0,50,7,0,0,0,0,0,0,0,0,0,0,71,0,1,1,55,11,2,1
2018-19,Kashmir,Pulwama,41,0,0,0,31,8,2,0,17,0,0,0,9,6,2,0,0,0,0,0,0,0,0,0,58,0,0,0,40,14,4,0
2018-19,Kashmir,Railways Jammu,2,0,0,0,1,1,0,0,1,0,0,0,1,0,0,0,0,0,0,0,0,0,0,0,3,0,0,0,2,1,0,0
2018-19,Kashmir,Railways Kashmir,0,0,0,0,0,0,0,0,0,0,0,0,0,0,0,0,0,0,0,0,0,0,0,0,0,0,0,0,0,0,0,0
2018-19,Kashmir,Railways Katra,0,0,0,0,0,0,0,0,0,0,0,0,0,0,0,0,0,0,0,0,0,0,0,0,0,0,0,0,0,0,0,0
2018-19,Kashmir,Rajouri,21,0,3,0,9,7,2,0,98,0,0,0,52,38,8,0,0,0,0,0,0,0,0,0,119,0,3,0,61,45,10,0
2018-19,Kashmir,Ramban,10,0,2,1,3,2,2,0,38,0,0,0,31,7,0,0,0,0,0,0,0,0,0,0,48,0,2,1,34,9,2,0
2018-19,Kashmir,Reasi,31,0,1,0,12,10,7,1,74,0,5,15,35,15,2,2,0,0,0,0,0,0,0,0,105,0,6,15,47,25,9,3
2018-19,Kashmir,Samba,19,1,1,1,8,7,1,0,44,2,3,3,29,3,3,1,0,0,0,0,0,0,0,0,63,3,4,4,37,10,4,1
2018-19,Kashmir,Shopian,35,0,0,5,30,0,0,0,13,0,0,3,10,0,0,0,0,0,0,0,0,0,0,0,48,0,0,8,40,0,0,0
2018-19,Kashmir,Sopore,27,0,1,5,14,3,2,2,21,0,0,1,11,9,0,0,0,0,0,0,0,0,0,0,48,0,1,6,25,12,2,2
2018-19,Kashmir,Srinagar,167,0,0,20,85,36,26,0,148,0,0,43,62,34,9,0,0,0,0,0,0,0,0,0,315,0,0,63,147,70,35,0
2018-19,Kashmir,Udhampur,57,1,0,8,25,14,8,1,110,2,2,17,69,15,5,0,0,0,0,0,0,0,0,0,167,3,2,25,94,29,13,1
2018-19,Kashmir,Total,757,5,15,83,385,164,83,22,1477,8,15,151,939,287,58,19,0,0,0,0,0,0,0,0,2234,13,30,234,1324,451,141,41
2018-19,Jharkhand,Bokaro,9,0,2,7,0,0,0,0,5,0,1,4,0,0,0,0,0,0,0,0,0,0,0,0,14,0,3,11,0,0,0,0
2018-19,Jharkhand,Chaibasa,2,0,0,1,1,0,0,0,16,0,1,13,2,0,0,0,0,0,0,0,0,0,0,0,18,0,1,14,3,0,0,0
2018-19,Jharkhand,Chatra,2,0,2,0,0,0,0,0,0,0,0,0,0,0,0,0,0,0,0,0,0,0,0,0,2,0,2,0,0,0,0,0
2018-19,Jharkhand,Deoghar,42,0,9,18,8,4,0,3,65,0,14,18,28,4,1,0,0,0,0,0,0,0,0,0,107,0,23,36,36,8,1,3
2018-19,Jharkhand,Dhanbad,46,0,6,9,11,13,7,0,16,0,4,6,3,2,1,0,0,0,0,0,0,0,0,0,62,0,10,15,14,15,8,0
2018-19,Jharkhand,Dhanbad Railway,3,1,0,0,1,0,1,0,4,0,0,0,3,0,0,1,0,0,0,0,0,0,0,0,7,1,0,0,4,0,1,1
2018-19,Jharkhand,Dumka,38,0,2,4,21,11,0,0,0,0,0,0,0,0,0,0,0,0,0,0,0,0,0,0,38,0,2,4,21,11,0,0
2018-19,Jharkhand,Garhwa,10,0,4,3,3,0,0,0,5,0,1,4,0,0,0,0,0,0,0,0,0,0,0,0,15,0,5,7,3,0,0,0
2018-19,Jharkhand,Giridih,16,0,5,11,0,0,0,0,22,0,10,12,0,0,0,0,0,0,0,0,0,0,0,0,38,0,15,23,0,0,0,0
2018-19,Jharkhand,Godda,10,0,0,10,0,0,0,0,1,0,0,1,0,0,0,0,0,0,0,0,0,0,0,0,11,0,0,11,0,0,0,0
2018-19,Jharkhand,Gumla,2,0,0,2,0,0,0,0,13,0,0,13,0,0,0,0,0,0,0,0,0,0,0,0,15,0,0,15,0,0,0,0
2018-19,Jharkhand,Hazaribagh,29,0,1,7,16,4,1,0,35,0,1,3,26,2,2,1,0,0,0,0,0,0,0,0,64,0,2,10,42,6,3,1
2018-19,Jharkhand,Jamshedpur,24,0,5,4,7,4,4,0,28,0,0,4,10,11,1,2,0,0,0,0,0,0,0,0,52,0,5,8,17,15,5,2
2018-19,Jharkhand,Jamshedpur Railway,17,0,3,1,7,2,2,2,13,3,1,2,4,2,1,0,0,0,0,0,0,0,0,0,30,3,4,3,11,4,3,2
2018-19,Jharkhand,Jamtara,23,1,3,0,12,3,2,2,16,0,0,3,10,1,2,0,0,0,0,0,0,0,0,0,39,1,3,3,22,4,4,2
2018-19,Jharkhand,Khunti,8,0,6,2,0,0,0,0,12,0,9,3,0,0,0,0,0,0,0,0,0,0,0,0,20,0,15,5,0,0,0,0
2018-19,Jharkhand,Koderma,0,0,0,0,0,0,0,0,0,0,0,0,0,0,0,0,0,0,0,0,0,0,0,0,0,0,0,0,0,0,0,0
2018-19,Jharkhand,Latehar,8,0,0,4,2,0,1,1,9,0,2,1,5,1,0,0,0,0,0,0,0,0,0,0,17,0,2,5,7,1,1,1
2018-19,Jharkhand,Lohardagga,0,0,0,0,0,0,0,0,0,0,0,0,0,0,0,0,0,0,0,0,0,0,0,0,0,0,0,0,0,0,0,0
2018-19,Jharkhand,Pakur,18,0,8,0,5,4,0,1,7,0,1,1,4,1,0,0,0,0,0,0,0,0,0,0,25,0,9,1,9,5,0,1
2018-19,Jharkhand,Palamu,48,1,11,8,18,4,4,2,73,0,3,17,44,7,1,1,0,0,0,0,0,0,0,0,121,1,14,25,62,11,5,3
2018-19,Jharkhand,Ramgarh,9,0,0,0,5,3,1,0,12,0,0,4,8,0,0,0,0,0,0,0,0,0,0,0,21,0,0,4,13,3,1,0
2018-19,Jharkhand,Ranchi,71,0,7,11,26,14,9,4,85,0,2,8,53,12,5,5,0,0,0,0,0,0,0,0,156,0,9,19,79,26,14,9
2018-19,Jharkhand,Sahebganj,7,0,0,7,0,0,0,0,0,0,0,0,0,0,0,0,0,0,0,0,0,0,0,0,7,0,0,7,0,0,0,0
2018-19,Jharkhand,Saraikela,0,0,0,0,0,0,0,0,0,0,0,0,0,0,0,0,0,0,0,0,0,0,0,0,0,0,0,0,0,0,0,0
2018-19,Jharkhand,Simdega,0,0,0,0,0,0,0,0,0,0,0,0,0,0,0,0,0,0,0,0,0,0,0,0,0,0,0,0,0,0,0,0
2018-19,Jharkhand,Total,442,3,74,109,143,66,32,15,437,3,50,117,200,43,14,10,0,0,0,0,0,0,0,0,879,6,124,226,343,109,46,25
2018-19,Karnataka,Bagalkot,56,2,0,1,14,22,8,9,120,1,0,3,97,15,2,2,0,0,0,0,0,0,0,0,176,3,0,4,111,37,10,11
2018-19,Karnataka,Bengaluru City,2072,18,22,12,783,658,357,222,3004,16,13,23,2371,353,116,112,0,0,0,0,0,0,0,0,5076,34,35,35,3154,1011,473,334
2018-19,Karnataka,Bengaluru District,283,10,17,0,54,107,66,29,666,19,15,1,452,143,20,16,0,0,0,0,0,0,0,0,949,29,32,1,506,250,86,45
2018-19,Karnataka,Belagavi District,129,0,1,1,51,43,19,14,256,1,4,11,195,40,1,4,0,0,0,0,0,0,0,0,385,1,5,12,246,83,20,18
2018-19,Karnataka,Ballari,146,12,13,2,36,50,25,8,222,10,16,5,133,52,5,1,0,0,0,0,0,0,0,0,368,22,29,7,169,102,30,9
2018-19,Karnataka,Bidar,43,0,0,1,17,13,7,5,89,0,0,1,71,10,3,4,0,0,0,0,0,0,0,0,132,0,0,2,88,23,10,9
2018-19,Karnataka,Vijayapura,86,1,4,9,39,22,4,7,182,0,3,26,132,17,2,2,0,0,0,0,0,0,0,0,268,1,7,35,171,39,6,9
2018-19,Karnataka,Chikkaballapura,74,4,5,0,20,30,10,5,303,10,3,0,223,54,8,5,0,0,0,0,0,0,0,0,377,14,8,0,243,84,18,10
2018-19,Karnataka,Chamarajnagar,74,5,3,0,23,20,11,12,151,1,2,0,122,17,3,6,0,0,0,0,0,0,0,0,225,6,5,0,145,37,14,18
2018-19,Karnataka,Chikkamagaluru,107,2,2,1,42,31,14,15,187,3,0,3,131,36,11,3,0,0,0,0,0,0,0,0,294,5,2,4,173,67,25,18
2018-19,Karnataka,Chitradurga,92,0,0,0,25,35,20,12,258,0,0,0,182,65,5,6,0,0,0,0,0,0,0,0,350,0,0,0,207,100,25,18
2018-19,Karnataka,Dakshina Kannada,89,3,0,0,24,30,24,8,87,6,2,0,51,19,8,1,0,0,0,0,0,0,0,0,176,9,2,0,75,49,32,9
2018-19,Karnataka,Davanagere,140,0,1,1,60,42,22,14,269,0,1,13,206,36,9,4,0,0,0,0,0,0,0,0,409,0,2,14,266,78,31,18
2018-19,Karnataka,Dharwad,27,2,0,0,3,7,12,3,56,1,0,0,40,13,2,0,0,0,0,0,0,0,0,0,83,3,0,0,43,20,14,3
2018-19,Karnataka,Gadag,38,0,0,0,18,13,4,3,84,0,0,0,73,10,0,1,0,0,0,0,0,0,0,0,122,0,0,0,91,23,4,4
2018-19,Karnataka,Kalaburgi,46,0,1,1,25,11,4,4,119,0,0,4,90,22,0,3,0,0,0,0,0,0,0,0,165,0,1,5,115,33,4,7
2018-19,Karnataka,Hassan,166,9,6,1,21,54,53,22,344,12,7,3,216,82,15,9,0,0,0,0,0,0,0,0,510,21,13,4,237,136,68,31
2018-19,Karnataka,Haveri,65,0,6,0,20,30,9,0,163,0,11,0,92,20,30,10,0,0,0,0,0,0,0,0,228,0,17,0,112,50,39,10
2018-19,Karnataka,Hubballi Dharwad City,88,2,2,0,30,32,15,7,116,8,7,1,79,14,5,2,0,0,0,0,0,0,0,0,204,10,9,1,109,46,20,9
2018-19,Karnataka,K.G.F.,39,5,4,0,8,15,4,3,97,3,4,0,67,21,0,2,0,0,0,0,0,0,0,0,136,8,8,0,75,36,4,5
2018-19,Karnataka,Kodagu,51,0,0,0,11,18,19,3,103,0,0,0,63,21,14,5,0,0,0,0,0,0,0,0,154,0,0,0,74,39,33,8
2018-19,Karnataka,Kolar,67,0,0,0,24,28,8,7,163,0,0,0,127,29,3,4,0,0,0,0,0,0,0,0,230,0,0,0,151,57,11,11
2018-19,Karnataka,Koppal,48,0,1,0,18,21,6,2,110,0,4,8,86,9,2,1,0,0,0,0,0,0,0,0,158,0,5,8,104,30,8,3
2018-19,Karnataka,Mandya,215,0,0,0,26,129,38,22,455,0,0,0,42,311,92,10,0,0,0,0,0,0,0,0,670,0,0,0,68,440,130,32
2018-19,Karnataka,Mangaluru City,131,3,1,1,39,52,24,11,107,1,2,0,85,15,1,3,0,0,0,0,0,0,0,0,238,4,3,1,124,67,25,14
2018-19,Karnataka,Mysuru City,182,7,6,1,55,55,36,22,264,11,11,2,179,33,15,13,0,0,0,0,0,0,0,0,446,18,17,3,234,88,51,35
2018-19,Karnataka,Mysuru District,187,11,6,0,50,52,44,24,396,15,17,2,262,71,18,11,0,0,0,0,0,0,0,0,583,26,23,2,312,123,62,35
2018-19,Karnataka,Raichur,62,6,2,3,18,22,5,6,140,4,4,1,112,13,3,3,0,0,0,0,0,0,0,0,202,10,6,4,130,35,8,9
2018-19,Karnataka,K.Railways,16,0,0,0,5,5,2,4,16,0,0,1,8,0,2,5,5,1,4,0,0,0,0,0,37,1,4,1,13,5,4,9
2018-19,Karnataka,Ramanagara,194,19,4,1,30,66,51,23,350,13,14,2,244,50,13,14,0,0,0,0,0,0,0,0,544,32,18,3,274,116,64,37
2018-19,Karnataka,Shimoga,212,0,0,0,71,76,46,19,425,0,0,0,372,35,8,10,0,0,0,0,0,0,0,0,637,0,0,0,443,111,54,29
2018-19,Karnataka,Tumakuru,158,7,9,23,48,35,23,13,454,10,8,67,312,46,2,9,0,0,0,0,0,0,0,0,612,17,17,90,360,81,25,22
2018-19,Karnataka,Udupi,83,0,3,6,14,29,21,10,65,1,1,4,46,8,3,2,0,0,0,0,0,0,0,0,148,1,4,10,60,37,24,12
2018-19,Karnataka,Uttara Kannada,106,8,3,0,34,37,17,7,176,9,1,2,135,21,2,6,0,0,0,0,0,0,0,0,282,17,4,2,169,58,19,13
2018-19,Karnataka,Yadgiri,34,1,4,2,11,11,3,2,32,1,0,0,29,0,2,0,0,0,0,0,0,0,0,0,66,2,4,2,40,11,5,2
2018-19,Karnataka,Belagavi City,91,0,1,1,26,31,16,16,62,0,0,2,47,10,1,2,0,0,0,0,0,0,0,0,153,0,1,3,73,41,17,18
2018-19,Karnataka,Kalaburgi City,28,0,0,4,12,7,3,2,24,2,1,0,16,4,1,0,0,0,0,0,0,0,0,0,52,2,1,4,28,11,4,2
2018-19,Karnataka,Total,5725,137,127,72,1805,1939,1050,595,10115,158,151,185,7188,1715,427,291,5,1,4,0,0,0,0,0,15845,296,282,257,8993,3654,1477,886
2018-19,Kerala,Alapuzha,280,4,4,41,90,61,51,29,707,5,6,46,493,121,25,11,0,0,0,0,0,0,0,0,987,9,10,87,583,182,76,40
2018-19,Kerala,Ernakulam Commr.,204,2,12,15,52,47,39,37,364,4,2,27,269,46,8,8,0,0,0,0,0,0,0,0,568,6,14,42,321,93,47,45
2018-19,Kerala,Ernakulam Rural,259,5,13,33,63,58,48,39,570,11,8,65,382,73,16,15,0,0,0,0,0,0,0,0,829,16,21,98,445,131,64,54
2018-19,Kerala,Idukki,164,5,9,27,56,37,19,11,302,6,8,42,186,44,9,7,0,0,0,0,0,0,0,0,466,11,17,69,242,81,28,18
2018-19,Kerala,Kannur,240,7,19,27,61,68,39,19,345,3,4,18,255,53,9,3,0,0,0,0,0,0,0,0,585,10,23,45,316,121,48,22
2018-19,Kerala,Kasargod,136,7,18,22,32,31,15,11,194,8,7,9,137,27,3,3,0,0,0,0,0,0,0,0,330,15,25,31,169,58,18,14
2018-19,Kerala,Kollam Commr.,250,14,14,50,36,49,60,27,633,6,18,42,427,101,28,11,0,0,0,0,0,0,0,0,883,20,32,92,463,150,88,38
2018-19,Kerala,Kollam Rural,232,11,19,28,43,35,61,35,654,21,11,26,468,112,8,8,0,0,0,0,0,0,0,0,886,32,30,54,511,147,69,43
2018-19,Kerala,Kottayam,224,7,9,13,45,53,73,24,547,3,10,43,378,83,23,7,0,0,0,0,0,0,0,0,771,10,19,56,423,136,96,31
2018-19,Kerala,Kozhikode Commr.,174,2,8,40,40,33,36,15,215,2,3,28,145,30,3,4,0,0,0,0,0,0,0,0,389,4,11,68,185,63,39,19
2018-19,Kerala,Kozhikode Rural,216,1,16,24,59,82,21,13,406,5,5,32,289,60,13,2,0,0,0,0,0,0,0,0,622,6,21,56,348,142,34,15
2018-19,Kerala,Malappuram,312,12,23,87,82,57,38,13,423,3,9,55,303,40,8,5,0,0,0,0,0,0,0,0,735,15,32,142,385,97,46,18
2018-19,Kerala,Palakkad,291,17,23,46,55,75,47,28,615,15,20,43,395,110,23,9,0,0,0,0,0,0,0,0,906,32,43,89,450,185,70,37
2018-19,Kerala,Pathanamthitta,159,7,7,33,30,35,33,14,346,12,15,21,227,52,7,12,0,0,0,0,0,0,0,0,505,19,22,54,257,87,40,26
2018-19,Kerala,Railways,18,0,0,1,9,3,3,2,4,0,0,0,3,1,0,0,0,0,0,0,0,0,0,0,22,0,0,1,12,4,3,2
2018-19,Kerala,Thrissur Commr.,292,9,17,43,51,70,63,39,474,13,15,36,313,71,12,14,0,0,0,0,0,0,0,0,766,22,32,79,364,141,75,53
2018-19,Kerala,Thrissur Rural,223,6,11,39,45,47,39,36,404,5,7,27,277,64,17,7,0,0,0,0,0,0,0,0,627,11,18,66,322,111,56,43
2018-19,Kerala,Trivandrum Commr.,265,7,13,55,59,51,41,39,499,7,10,43,356,51,20,12,0,0,0,0,0,0,0,0,764,14,23,98,415,102,61,51
2018-19,Kerala,Trivandrum Rural,367,22,33,61,46,72,84,49,959,20,38,70,575,190,40,26,0,0,0,0,0,0,0,0,1326,42,71,131,621,262,124,75
2018-19,Kerala,Wayanadu,81,4,6,21,10,13,14,13,181,5,2,28,119,23,2,2,3,0,1,0,1,1,0,0,265,9,9,49,130,37,16,15
2018-19,Kerala,Crime Branch,0,0,0,0,0,0,0,0,1,0,0,0,0,0,0,1,0,0,0,0,0,0,0,0,1,0,0,0,0,0,0,1
2018-19,Kerala,Total,4387,149,274,706,964,977,824,493,8843,154,198,701,5997,1352,274,167,3,0,1,0,1,1,0,0,13233,303,473,1407,6962,2330,1098,660
2018-19,Madhya Pradesh,Agar,48,1,3,3,14,14,5,8,224,0,2,17,174,25,6,0,0,0,0,0,0,0,0,0,272,1,5,20,188,39,11,8
2018-19,Madhya Pradesh,Alirajpur,47,1,1,0,12,17,15,1,426,0,12,88,246,69,10,1,0,0,0,0,0,0,0,0,473,1,13,88,258,86,25,2
2018-19,Madhya Pradesh,Anuppur,132,2,9,19,52,26,16,8,409,1,10,106,212,64,10,6,0,0,0,0,0,0,0,0,541,3,19,125,264,90,26,14
2018-19,Madhya Pradesh,Ashok Nagar,123,0,8,21,34,48,6,6,297,0,7,77,156,47,10,0,0,0,0,0,0,0,0,0,420,0,15,98,190,95,16,6
2018-19,Madhya Pradesh,Balaghat,303,0,7,21,128,79,50,18,924,0,12,184,603,93,21,11,0,0,0,0,0,0,0,0,1227,0,19,205,731,172,71,29
2018-19,Madhya Pradesh,Barwani,121,6,8,9,58,25,7,8,408,3,9,74,252,55,10,5,0,0,0,0,0,0,0,0,529,9,17,83,310,80,17,13
2018-19,Madhya Pradesh,Betul,278,5,7,25,105,66,41,29,910,10,21,203,586,73,14,3,0,0,0,0,0,0,0,0,1188,15,28,228,691,139,55,32
2018-19,Madhya Pradesh,Bhind,144,0,19,23,72,22,8,0,246,0,18,74,132,18,2,2,0,0,0,0,0,0,0,0,390,0,37,97,204,40,10,2
2018-19,Madhya Pradesh,Bhopal,517,1,63,71,134,149,69,30,928,2,45,230,387,185,58,21,0,0,0,0,0,0,0,0,1445,3,108,301,521,334,127,51
2018-19,Madhya Pradesh,Bhopal Railway,57,5,0,2,18,15,8,9,71,6,4,6,42,9,4,0,0,0,0,0,0,0,0,0,128,11,4,8,60,24,12,9
2018-19,Madhya Pradesh,Burhanpur,102,0,6,7,47,21,18,3,241,1,5,50,147,23,13,2,0,0,0,0,0,0,0,0,343,1,11,57,194,44,31,5
2018-19,Madhya Pradesh,Chhatarpur,229,1,15,38,103,40,21,11,647,2,25,170,382,58,6,4,0,0,0,0,0,0,0,0,876,3,40,208,485,98,27,15
2018-19,Madhya Pradesh,Chhindwara,423,0,10,20,143,144,76,30,1195,1,14,234,673,215,45,13,0,0,0,0,0,0,0,0,1618,1,24,254,816,359,121,43
2018-19,Madhya Pradesh,Damoh,293,0,15,16,80,129,34,19,930,0,44,162,408,267,31,18,0,0,0,0,0,0,0,0,1223,0,59,178,488,396,65,37
2018-19,Madhya Pradesh,Datia,125,0,5,18,60,25,12,5,221,0,2,39,140,35,3,2,0,0,0,0,0,0,0,0,346,0,7,57,200,60,15,7
2018-19,Madhya Pradesh,Dewas,273,3,15,27,95,85,40,8,778,2,11,171,370,178,35,11,0,0,0,0,0,0,0,0,1051,5,26,198,465,263,75,19
2018-19,Madhya Pradesh,Dhar,316,1,12,25,165,62,35,16,1364,0,29,325,821,160,22,7,0,0,0,0,0,0,0,0,1680,1,41,350,986,222,57,23
2018-19,Madhya Pradesh,Dindori,53,0,2,15,16,12,7,1,291,1,5,92,148,38,7,0,0,0,0,0,0,0,0,0,344,1,7,107,164,50,14,1
2018-19,Madhya Pradesh,Guna,210,0,15,24,97,41,31,2,511,1,7,124,312,54,9,4,0,0,0,0,0,0,0,0,721,1,22,148,409,95,40,6
2018-19,Madhya Pradesh,Gwalior,738,4,64,81,282,174,87,46,1092,1,45,210,607,173,35,21,0,0,0,0,0,0,0,0,1830,5,109,291,889,347,122,67
2018-19,Madhya Pradesh,Harda,92,1,7,14,31,21,11,7,379,0,7,71,255,40,5,1,0,0,0,0,0,0,0,0,471,1,14,85,286,61,16,8
2018-19,Madhya Pradesh,Hoshangabad,453,0,13,32,255,33,94,26,752,0,11,158,508,56,14,5,0,0,0,0,0,0,0,0,1205,0,24,190,763,89,108,31
2018-19,Madhya Pradesh,Indore,1608,5,99,122,693,441,153,95,2697,3,141,486,1402,540,82,43,0,0,0,0,0,0,0,0,4305,8,240,608,2095,981,235,138
2018-19,Madhya Pradesh,Indore Railway,18,0,0,1,4,8,3,2,31,1,1,0,22,4,2,1,0,0,0,0,0,0,0,0,49,1,1,1,26,12,5,3
2018-19,Madhya Pradesh,Jabalpur,989,2,81,74,388,257,135,52,1824,2,75,356,1052,238,67,34,0,0,0,0,0,0,0,0,2813,4,156,430,1440,495,202,86
2018-19,Madhya Pradesh,Jabalpur Railway,29,0,1,1,9,8,3,7,30,0,0,9,12,4,2,3,0,0,0,0,0,0,0,0,59,0,1,10,21,12,5,10
2018-19,Madhya Pradesh,Jhabua,86,1,4,5,46,26,3,1,446,0,17,56,326,42,5,0,0,0,0,0,0,0,0,0,532,1,21,61,372,68,8,1
2018-19,Madhya Pradesh,Katni,200,0,13,13,81,56,26,11,579,0,5,82,321,137,29,5,0,0,0,0,0,0,0,0,779,0,18,95,402,193,55,16
2018-19,Madhya Pradesh,Khandwa,158,0,4,12,68,34,24,16,556,1,12,128,325,78,,1,0,0,0,0,0,0,0,0,714,1,16,140,393,112,35,17
2018-19,Madhya Pradesh,Khargone,220,11,16,12,80,76,25,0,993,1,10,54,214,575,119,20,0,0,0,0,0,0,0,0,1213,12,26,66,294,651,144,20
2018-19,Madhya Pradesh,Mandla,144,0,6,12,57,38,20,11,453,0,5,77,305,48,14,4,0,0,0,0,0,0,0,0,597,0,11,89,362,86,34,15
2018-19,Madhya Pradesh,Mandsaur,208,1,5,18,112,52,19,1,640,0,11,90,389,135,15,0,0,0,0,0,0,0,0,0,848,1,16,108,501,187,34,1
2018-19,Madhya Pradesh,Morena,256,0,31,50,99,51,15,10,397,1,21,52,241,71,6,5,0,0,0,0,0,0,0,0,653,1,52,102,340,122,21,15
2018-19,Madhya Pradesh,Narsinghpur,260,0,5,20,60,90,70,15,584,0,45,80,206,135,95,23,0,0,0,0,0,0,0,0,844,0,50,100,266,225,165,38
2018-19,Madhya Pradesh,Neemuch,124,0,1,11,72,35,4,1,401,0,2,28,319,46,5,1,0,0,0,0,0,0,0,0,525,0,3,39,391,81,9,2
2018-19,Madhya Pradesh,Panna,122,2,8,12,49,28,15,8,397,1,14,118,196,54,9,5,0,0,0,0,0,0,0,0,519,3,22,130,245,82,24,13
2018-19,Madhya Pradesh,Raisen,253,0,11,23,120,63,21,15,742,0,10,160,450,98,15,9,0,0,0,0,0,0,0,0,995,0,21,183,570,161,36,24
2018-19,Madhya Pradesh,Rajgarh,162,0,8,16,46,53,33,6,575,0,15,123,300,111,22,4,0,0,0,0,0,0,0,0,737,0,23,139,346,164,55,10
2018-19,Madhya Pradesh,Ratlam,295,2,12,24,180,35,42,0,1032,16,208,397,298,112,1,0,0,0,0,0,0,0,0,0,1327,18,220,421,478,147,43,0
2018-19,Madhya Pradesh,Rewa,146,0,98,44,2,2,0,0,267,0,122,144,1,0,0,0,0,0,0,0,0,0,0,0,413,0,220,188,3,2,0,0
2018-19,Madhya Pradesh,Sagar,539,1,40,73,244,103,59,19,1235,0,27,318,731,133,15,11,0,0,0,0,0,0,0,0,1774,1,67,391,975,236,74,30
2018-19,Madhya Pradesh,Satna,431,1,51,68,125,108,42,36,1041,1,59,234,487,210,33,17,0,0,0,0,0,0,0,0,1472,2,110,302,612,318,75,53
2018-19,Madhya Pradesh,Seoni,188,3,7,13,76,56,23,10,603,3,9,153,387,43,4,4,0,0,0,0,0,0,0,0,791,6,16,166,463,99,27,14
2018-19,Madhya Pradesh,Shahdol,222,0,14,37,99,47,19,6,597,0,21,118,349,95,12,2,0,0,0,0,0,0,0,0,819,0,35,155,448,142,31,8
2018-19,Madhya Pradesh,Shajapur,105,0,4,15,45,19,14,8,296,0,3,60,177,48,5,3,0,0,0,0,0,0,0,0,401,0,7,75,222,67,19,11
2018-19,Madhya Pradesh,Sheopur,42,0,7,4,18,7,4,2,124,0,2,18,89,12,3,0,0,0,0,0,0,0,0,0,166,0,9,22,107,19,7,2
2018-19,Madhya Pradesh,Shivpuri,184,0,15,27,47,55,29,11,503,0,15,125,211,124,23,5,0,0,0,0,0,0,0,0,687,0,30,152,258,179,52,16
2018-19,Madhya Pradesh,Sidhi,135,0,28,24,44,25,7,7,419,2,27,119,216,47,5,3,0,0,0,0,0,0,0,0,554,2,55,143,260,72,12,10
2018-19,Madhya Pradesh,Sehore,235,0,25,22,55,81,35,17,690,0,54,136,322,159,19,0,0,0,0,0,0,0,0,0,925,0,79,158,377,240,54,17
2018-19,Madhya Pradesh,Singrauli,109,1,17,15,37,26,9,4,313,1,11,95,169,31,4,2,0,0,0,0,0,0,0,0,422,2,28,110,206,57,13,6
2018-19,Madhya Pradesh,Tikamgarh,100,1,10,22,46,12,6,3,346,0,8,105,182,38,8,5,0,0,0,0,0,0,0,0,446,1,18,127,228,50,14,8
2018-19,Madhya Pradesh,Ujjain,477,2,19,49,204,124,54,25,935,6,12,172,618,95,20,12,0,0,0,0,0,0,0,0,1412,8,31,221,822,219,74,37
2018-19,Madhya Pradesh,Umaria,82,0,10,13,37,14,5,3,222,0,12,57,125,16,9,3,0,0,0,0,0,0,0,0,304,0,22,70,162,30,14,6
2018-19,Madhya Pradesh,Vidisha,303,6,18,35,113,82,31,18,573,1,23,129,336,64,16,4,0,0,0,0,0,0,0,0,876,7,41,164,449,146,47,22
2018-19,Madhya Pradesh,Cyber Crime Cell,0,0,0,0,0,0,0,0,0,0,0,0,0,0,0,0,0,0,0,0,0,0,0,0,0,0,0,0,0,0,0,0
2018-19,Madhya Pradesh,Niwari,52,0,3,7,26,7,3,6,108,0,2,13,70,21,2,0,0,0,0,0,0,0,0,0,160,0,5,20,96,28,5,6
2018-19,Madhya Pradesh,Total,13559,70,975,1405,5383,3367,1642,717,33893,71,1344,7157,18409,5499,1047,366,0,0,0,0,0,0,0,0,47452,141,2319,8562,23792,8866,2689,1083
2018-19,Maharashtra,Ahmednagar,1003,57,20,25,568,194,104,35,1427,51,10,16,934,278,125,13,0,0,0,0,0,0,0,0,2430,108,30,41,1502,472,229,48
2018-19,Maharashtra,Akola,334,0,0,1,80,129,93,31,425,0,0,2,280,107,27,9,0,0,0,0,0,0,0,0,759,0,0,3,360,236,120,40
2018-19,Maharashtra,Amravati Commr.,343,0,0,1,77,152,83,30,399,0,0,0,224,128,30,17,0,0,0,0,0,0,0,0,742,0,0,1,301,280,113,47
2018-19,Maharashtra,Amravati Rural,291,0,0,0,98,108,53,32,652,0,0,0,497,119,21,15,0,0,0,0,0,0,0,0,943,0,0,0,595,227,74,47
2018-19,Maharashtra,Aurangabad Commr.,624,14,8,11,214,255,97,25,733,13,8,9,422,212,52,17,0,0,0,0,0,0,0,0,1357,27,16,20,636,467,149,42
2018-19,Maharashtra,Aurangabad Rural,161,0,0,0,63,53,35,10,213,0,0,0,140,51,19,3,0,0,0,0,0,0,0,0,374,0,0,0,203,104,54,13
2018-19,Maharashtra,Beed,224,12,9,0,56,83,43,21,312,12,7,1,163,106,19,4,0,0,0,0,0,0,0,0,536,24,16,1,219,189,62,25
2018-19,Maharashtra,Bhandara,295,0,11,21,110,81,48,24,648,0,11,71,481,48,27,10,0,0,0,0,0,0,0,0,943,0,22,92,591,129,75,34
2018-19,Maharashtra,Buldhana,341,18,13,0,137,89,53,31,505,19,11,2,364,74,16,19,0,0,0,0,0,0,0,0,846,37,24,2,501,163,69,50
2018-19,Maharashtra,Chandrapur,597,0,0,0,295,183,99,20,919,0,0,0,493,342,58,26,0,0,0,0,0,0,0,0,1516,0,0,0,788,525,157,46
2018-19,Maharashtra,Dhule,306,4,2,1,198,59,37,5,465,13,9,1,319,71,43,9,0,0,0,0,0,0,0,0,771,17,11,2,517,130,80,14
2018-19,Maharashtra,Gadchiroli,106,0,1,0,43,31,21,10,245,1,1,0,200,32,6,5,0,0,0,0,0,0,0,0,351,1,2,0,243,63,27,15
2018-19,Maharashtra,Gondia,168,0,0,0,25,71,68,4,420,0,0,0,295,107,15,3,0,0,0,0,0,0,0,0,588,0,0,0,320,178,83,7
2018-19,Maharashtra,Hingoli,131,0,0,5,59,44,17,6,152,0,0,13,98,33,6,2,0,0,0,0,0,0,0,0,283,0,0,18,157,77,23,8
2018-19,Maharashtra,Jalgaon,667,52,23,4,179,230,128,51,991,34,29,2,618,253,40,15,0,0,0,0,0,0,0,0,1658,86,52,6,797,483,168,66
2018-19,Maharashtra,Jalna,18,0,0,0,9,7,2,0,48,0,0,0,30,11,5,2,0,0,0,0,0,0,0,0,66,0,0,0,39,18,7,2
2018-19,Maharashtra,Kolhapur,713,41,35,1,280,204,84,68,1278,44,36,2,997,141,24,34,0,0,0,0,0,0,0,0,1991,85,71,3,1277,345,108,102
2018-19,Maharashtra,Latur,239,0,0,0,110,70,43,16,437,0,0,0,359,57,15,6,0,0,0,0,0,0,0,0,676,0,0,0,469,127,58,22
2018-19,Maharashtra,Mumbai Commr.,5167,25,258,383,1257,1715,1022,507,6295,19,237,1120,2671,1573,420,255,0,0,0,0,0,0,0,0,11462,44,495,1503,3928,3288,1442,762
2018-19,Maharashtra,Mumbai Railway,96,0,2,1,36,26,18,13,90,3,2,1,52,19,8,5,0,0,0,0,0,0,0,0,186,3,4,2,88,45,26,18
2018-19,Maharashtra,Nagpur Commr.,1616,5,7,17,534,544,331,178,1994,12,28,81,1142,495,140,96,0,0,0,0,0,0,0,0,3610,17,35,98,1676,1039,471,274
2018-19,Maharashtra,Nagpur Railway,22,0,0,0,6,8,4,4,21,0,0,0,15,2,2,2,0,0,0,0,0,0,0,0,43,0,0,0,21,10,6,6
2018-19,Maharashtra,Nagpur Rural,454,0,0,0,227,161,45,21,669,0,0,0,323,210,79,57,0,0,0,0,0,0,0,0,1123,0,0,0,550,371,124,78
2018-19,Maharashtra,Nanded,363,5,0,4,105,152,75,22,454,4,2,4,283,127,26,8,0,0,0,0,0,0,0,0,817,9,2,8,388,279,101,30
2018-19,Maharashtra,Nandurbar,164,3,7,0,79,38,18,19,272,11,9,1,208,35,6,2,0,0,0,0,0,0,0,0,436,14,16,1,287,73,24,21
2018-19,Maharashtra,Nasik Commr.,773,26,232,301,152,62,0,0,1002,17,21,9,602,270,64,19,0,0,0,0,0,0,0,0,1775,43,253,310,754,332,64,19
2018-19,Maharashtra,Nasik Rural,653,6,1,15,333,189,68,41,1072,7,8,19,800,183,41,14,0,0,0,0,0,0,0,0,1725,13,9,34,1133,372,109,55
2018-19,Maharashtra,Navi Mumbai,865,26,14,1,231,342,186,65,1033,23,11,4,576,328,73,18,0,0,0,0,0,0,0,0,1898,49,25,5,807,670,259,83
2018-19,Maharashtra,Osmanabad,184,10,3,0,71,47,32,21,311,5,8,1,204,70,17,6,0,0,0,0,0,0,0,0,495,15,11,1,275,117,49,27
2018-19,Maharashtra,Palghar,895,50,31,1,244,328,177,64,1232,45,33,5,705,340,76,28,0,0,0,0,0,0,0,0,2127,95,64,6,949,668,253,92
2018-19,Maharashtra,Parbhani,205,0,0,0,103,66,20,16,232,0,0,0,172,38,11,11,0,0,0,0,0,0,0,0,437,0,0,0,275,104,31,27
2018-19,Maharashtra,Pune Commr.,1731,6,7,3,629,591,322,173,1831,11,16,8,1242,390,86,78,0,0,0,0,0,0,0,0,3562,17,23,11,1871,981,408,251
2018-19,Maharashtra,Pune Railway,42,1,1,0,14,19,4,3,30,1,1,0,18,3,6,1,0,0,0,0,0,0,0,0,72,2,2,0,32,22,10,4
2018-19,Maharashtra,Pune Rural,1028,29,31,1,254,408,229,76,1677,32,27,4,979,497,103,35,0,0,0,0,0,0,0,0,2705,61,58,5,1233,905,332,111
2018-19,Maharashtra,Raigad,322,4,12,22,59,109,81,35,368,6,8,60,174,92,19,9,0,0,0,0,0,0,0,0,690,10,20,82,233,201,100,44
2018-19,Maharashtra,Ratnagiri,234,7,10,1,67,65,50,34,324,2,11,9,200,71,7,24,0,0,0,0,0,0,0,0,558,9,21,10,267,136,57,58
2018-19,Maharashtra,Sangli,514,8,4,1,161,172,116,52,868,10,1,3,585,192,50,27,0,0,0,0,0,0,0,0,1382,18,5,4,746,364,166,79
2018-19,Maharashtra,Satara,547,16,10,0,186,176,63,96,1129,14,21,0,889,141,32,32,0,0,0,0,0,0,0,0,1676,30,31,0,1075,317,95,128
2018-19,Maharashtra,Sindhudurg,99,3,2,0,27,33,19,15,114,4,1,0,70,21,11,7,0,0,0,0,0,0,0,0,213,7,3,0,97,54,30,22
2018-19,Maharashtra,Solapur Commr.,308,13,5,2,78,114,71,25,445,6,13,29,256,105,23,13,0,0,0,0,0,0,0,0,753,19,18,31,334,219,94,38
2018-19,Maharashtra,Solapur Rural,473,0,0,0,150,175,107,41,742,0,0,0,418,246,52,26,0,0,0,0,0,0,0,0,1215,0,0,0,568,421,159,67
2018-19,Maharashtra,Thane Commr.,1995,0,0,7,857,804,200,127,2389,0,0,3,1769,485,96,36,0,0,0,0,0,0,0,0,4384,0,0,10,2626,1289,296,163
2018-19,Maharashtra,Thane Rural,573,0,0,0,260,184,81,48,697,0,0,0,529,116,25,27,0,0,0,0,0,0,0,0,1270,0,0,0,789,300,106,75
2018-19,Maharashtra,Wardha,376,0,0,2,112,132,74,56,601,0,0,1,338,181,59,22,0,0,0,0,0,0,0,0,977,0,0,3,450,313,133,78
2018-19,Maharashtra,Washim,173,0,0,11,51,69,33,9,251,0,0,22,152,65,10,2,0,0,0,0,0,0,0,0,424,0,0,33,203,134,43,11
2018-19,Maharashtra,Yavatmal,412,0,0,0,195,141,57,19,758,0,0,1,621,118,10,8,0,0,0,0,0,0,0,0,1170,0,0,1,816,259,67,27
2018-19,Maharashtra,Pimpri Chinchwad City,1095,0,2,1,336,459,203,94,1315,0,1,12,773,411,83,35,0,0,0,0,0,0,0,0,2410,0,3,13,1109,870,286,129
2018-19,Maharashtra,Aurangabad Railway,32,0,0,0,15,10,3,4,21,0,0,0,14,5,2,0,0,0,0,0,0,0,0,0,53,0,0,0,29,15,5,4
2018-19,Maharashtra,Total,27972,441,761,844,9430,9382,4817,2297,38506,419,581,1516,23694,8999,2185,1112,0,0,0,0,0,0,0,0,66478,860,1342,2360,33124,18381,7002,3409
2018-19,Manipur,Bishnupur,40,0,4,5,15,5,10,1,38,2,2,3,12,15,4,0,0,0,0,0,0,0,0,0,78,2,6,8,27,20,14,1
2018-19,Manipur,Chandel,1,0,0,0,1,0,0,0,1,0,0,0,1,0,0,0,0,0,0,0,0,0,0,0,2,0,0,0,2,0,0,0
2018-19,Manipur,Churachandpur,0,0,0,0,0,0,0,0,0,0,0,0,0,0,0,0,0,0,0,0,0,0,0,0,0,0,0,0,0,0,0,0
2018-19,Manipur,CID,0,0,0,0,0,0,0,0,0,0,0,0,0,0,0,0,0,0,0,0,0,0,0,0,0,0,0,0,0,0,0,0
2018-19,Manipur,Imphal East,58,2,5,8,12,19,8,4,84,0,7,10,28,31,6,2,0,0,0,0,0,0,0,0,142,2,12,18,40,50,14,6
2018-19,Manipur,Imphal West,24,0,2,3,12,4,2,1,35,1,4,5,16,6,2,1,0,0,0,0,0,0,0,0,59,1,6,8,28,10,4,2
2018-19,Manipur,Senapati,0,0,0,0,0,0,0,0,0,0,0,0,0,0,0,0,0,0,0,0,0,0,0,0,0,0,0,0,0,0,0,0
2018-19,Manipur,Tamenglong,0,0,0,0,0,0,0,0,0,0,0,0,0,0,0,0,0,0,0,0,0,0,0,0,0,0,0,0,0,0,0,0
2018-19,Manipur,Thoubal,30,1,1,7,8,7,3,3,47,0,13,12,9,12,1,0,0,0,0,0,0,0,0,0,77,1,14,19,17,19,4,3
2018-19,Manipur,Ukhrul,0,0,0,0,0,0,0,0,0,0,0,0,0,0,0,0,0,0,0,0,0,0,0,0,0,0,0,0,0,0,0,0
2018-19,Manipur,Kakching,22,0,2,8,5,4,3,0,29,0,0,3,12,8,5,1,0,0,0,0,0,0,0,0,51,0,2,11,17,12,8,1
2018-19,Manipur,Kamjong,0,0,0,0,0,0,0,0,0,0,0,0,0,0,0,0,0,0,0,0,0,0,0,0,0,0,0,0,0,0,0,0
2018-19,Manipur,Kangpokpi,0,0,0,0,0,0,0,0,0,0,0,0,0,0,0,0,0,0,0,0,0,0,0,0,0,0,0,0,0,0,0,0
2018-19,Manipur,Jiribam,6,0,0,1,2,1,1,1,7,0,0,0,5,1,1,0,0,0,0,0,0,0,0,0,13,0,0,1,7,2,2,1
2018-19,Manipur,Noney,0,0,0,0,0,0,0,0,0,0,0,0,0,0,0,0,0,0,0,0,0,0,0,0,0,0,0,0,0,0,0,0
2018-19,Manipur,Pherzawl,0,0,0,0,0,0,0,0,0,0,0,0,0,0,0,0,0,0,0,0,0,0,0,0,0,0,0,0,0,0,0,0
2018-19,Manipur,Tengnoupal,1,0,0,1,0,0,0,0,1,0,0,0,1,0,0,0,0,0,0,0,0,0,0,0,2,0,0,1,1,0,0,0
2018-19,Manipur,Narcotic,0,0,0,0,0,0,0,0,0,0,0,0,0,0,0,0,0,0,0,0,0,0,0,0,0,0,0,0,0,0,0,0
2018-19,Manipur,Total,182,3,14,33,55,40,27,10,242,3,26,33,84,73,19,4,0,0,0,0,0,0,0,0,424,6,40,66,139,113,46,14
2018-19,Meghalaya,Garo Hills East,0,0,0,0,0,0,0,0,5,0,0,3,2,0,0,0,0,0,0,0,0,0,0,0,5,0,0,3,2,0,0,0
2018-19,Meghalaya,Garo Hills North,2,0,1,1,0,0,0,0,1,0,0,1,0,0,0,0,0,0,0,0,0,0,0,0,3,0,1,2,0,0,0,0
2018-19,Meghalaya,Garo Hills South,0,0,0,0,0,0,0,0,0,0,0,0,0,0,0,0,0,0,0,0,0,0,0,0,0,0,0,0,0,0,0,0
2018-19,Meghalaya,Garo Hills South West,0,0,0,0,0,0,0,0,2,0,0,0,2,0,0,0,0,0,0,0,0,0,0,0,2,0,0,0,2,0,0,0
2018-19,Meghalaya,Garo Hills West,19,1,0,4,8,4,2,0,35,0,0,8,23,3,1,0,0,0,0,0,0,0,0,0,54,1,0,12,31,7,3,0
2018-19,Meghalaya,Jaintia Hills West,4,0,0,0,1,1,2,0,1,0,0,1,0,0,0,0,0,0,0,0,0,0,0,0,5,0,0,1,1,1,2,0
2018-19,Meghalaya,Jaintia Hills East,7,0,1,0,5,1,0,0,19,0,1,12,3,3,0,0,0,0,0,0,0,0,0,0,26,0,2,12,8,4,0,0
2018-19,Meghalaya,Khasi Hills East,117,1,9,23,36,35,9,4,133,0,7,29,63,25,7,2,0,0,0,0,0,0,0,0,250,1,16,52,99,60,16,6
2018-19,Meghalaya,Khasi Hills South West,0,0,0,0,0,0,0,0,0,0,0,0,0,0,0,0,0,0,0,0,0,0,0,0,0,0,0,0,0,0,0,0
2018-19,Meghalaya,Khasi Hills West,0,0,0,0,0,0,0,0,0,0,0,0,0,0,0,0,0,0,0,0,0,0,0,0,0,0,0,0,0,0,0,0
2018-19,Meghalaya,Ri-Bhoi,7,0,0,0,6,0,0,1,4,0,0,1,3,0,0,0,0,0,0,0,0,0,0,0,11,0,0,1,9,0,0,1
2018-19,Meghalaya,Cyber Cell,0,0,0,0,0,0,0,0,0,0,0,0,0,0,0,0,0,0,0,0,0,0,0,0,0,0,0,0,0,0,0,0
2018-19,Meghalaya,Total,156,2,11,28,56,41,13,5,200,0,8,55,96,31,8,2,0,0,0,0,0,0,0,0,356,2,19,83,152,72,21,7
2018-19,Mizoram,Aizawl,0,0,0,0,0,0,0,0,0,0,0,0,0,0,0,0,0,0,0,0,0,0,0,0,0,0,0,0,0,0,0,0
2018-19,Mizoram,Champhai,0,0,0,0,0,0,0,0,0,0,0,0,0,0,0,0,0,0,0,0,0,0,0,0,0,0,0,0,0,0,0,0
2018-19,Mizoram,Kolasib,0,0,0,0,0,0,0,0,0,0,0,0,0,0,0,0,0,0,0,0,0,0,0,0,0,0,0,0,0,0,0,0
2018-19,Mizoram,Lawngtlai,0,0,0,0,0,0,0,0,0,0,0,0,0,0,0,0,0,0,0,0,0,0,0,0,0,0,0,0,0,0,0,0
2018-19,Mizoram,Lunglei,0,0,0,0,0,0,0,0,0,0,0,0,0,0,0,0,0,0,0,0,0,0,0,0,0,0,0,0,0,0,0,0
2018-19,Mizoram,Mamit,0,0,0,0,0,0,0,0,0,0,0,0,0,0,0,0,0,0,0,0,0,0,0,0,0,0,0,0,0,0,0,0
2018-19,Mizoram,Saiha,0,0,0,0,0,0,0,0,0,0,0,0,0,0,0,0,0,0,0,0,0,0,0,0,0,0,0,0,0,0,0,0
2018-19,Mizoram,Serchhip,0,0,0,0,0,0,0,0,0,0,0,0,0,0,0,0,0,0,0,0,0,0,0,0,0,0,0,0,0,0,0,0
2018-19,Mizoram,Spl Narcotic,0,0,0,0,0,0,0,0,0,0,0,0,0,0,0,0,0,0,0,0,0,0,0,0,0,0,0,0,0,0,0,0
2018-19,Mizoram,Total,0,0,0,0,0,0,0,0,0,0,0,0,0,0,0,0,0,0,0,0,0,0,0,0,0,0,0,0,0,0,0,0
2018-19,Nagaland,Dimapur,18,0,5,2,5,5,1,0,40,2,5,23,7,3,0,0,0,0,0,0,0,0,0,0,58,2,10,25,12,8,1,0
2018-19,Nagaland,Kiphire,0,0,0,0,0,0,0,0,0,0,0,0,0,0,0,0,0,0,0,0,0,0,0,0,0,0,0,0,0,0,0,0
2018-19,Nagaland,Kohima,0,0,0,0,0,0,0,0,0,0,0,0,0,0,0,0,0,0,0,0,0,0,0,0,0,0,0,0,0,0,0,0
2018-19,Nagaland,Longleng,0,0,0,0,0,0,0,0,0,0,0,0,0,0,0,0,0,0,0,0,0,0,0,0,0,0,0,0,0,0,0,0
2018-19,Nagaland,Mokokchung,0,0,0,0,0,0,0,0,0,0,0,0,0,0,0,0,0,0,0,0,0,0,0,0,0,0,0,0,0,0,0,0
2018-19,Nagaland,Mon,0,0,0,0,0,0,0,0,0,0,0,0,0,0,0,0,0,0,0,0,0,0,0,0,0,0,0,0,0,0,0,0
2018-19,Nagaland,Peren,0,0,0,0,0,0,0,0,0,0,0,0,0,0,0,0,0,0,0,0,0,0,0,0,0,0,0,0,0,0,0,0
2018-19,Nagaland,Phek,0,0,0,0,0,0,0,0,0,0,0,0,0,0,0,0,0,0,0,0,0,0,0,0,0,0,0,0,0,0,0,0
2018-19,Nagaland,Tuensang,0,0,0,0,0,0,0,0,0,0,0,0,0,0,0,0,0,0,0,0,0,0,0,0,0,0,0,0,0,0,0,0
2018-19,Nagaland,Wokha,0,0,0,0,0,0,0,0,0,0,0,0,0,0,0,0,0,0,0,0,0,0,0,0,0,0,0,0,0,0,0,0
2018-19,Nagaland,Zunheboto,0,0,0,0,0,0,0,0,0,0,0,0,0,0,0,0,0,0,0,0,0,0,0,0,0,0,0,0,0,0,0,0
2018-19,Nagaland,Total,18,0,5,2,5,5,1,0,40,2,5,23,7,3,0,0,0,0,0,0,0,0,0,0,58,2,10,25,12,8,1,0
2018-19,Odisha,Angul,0,0,0,0,0,0,0,0,0,0,0,0,0,0,0,0,0,0,0,0,0,0,0,0,0,0,0,0,0,0,0,0
2018-19,Odisha,Balasore,0,0,0,0,0,0,0,0,0,0,0,0,0,0,0,0,0,0,0,0,0,0,0,0,0,0,0,0,0,0,0,0
2018-19,Odisha,Baragarh,0,0,0,0,0,0,0,0,0,0,0,0,0,0,0,0,0,0,0,0,0,0,0,0,0,0,0,0,0,0,0,0
2018-19,Odisha,Berhampur,0,0,0,0,0,0,0,0,0,0,0,0,0,0,0,0,0,0,0,0,0,0,0,0,0,0,0,0,0,0,0,0
2018-19,Odisha,Bhadrak,0,0,0,0,0,0,0,0,0,0,0,0,0,0,0,0,0,0,0,0,0,0,0,0,0,0,0,0,0,0,0,0
2018-19,Odisha,Bolangir,0,0,0,0,0,0,0,0,0,0,0,0,0,0,0,0,0,0,0,0,0,0,0,0,0,0,0,0,0,0,0,0
2018-19,Odisha,Boudh,0,0,0,0,0,0,0,0,0,0,0,0,0,0,0,0,0,0,0,0,0,0,0,0,0,0,0,0,0,0,0,0
2018-19,Odisha,Cuttack,0,0,0,0,0,0,0,0,0,0,0,0,0,0,0,0,0,0,0,0,0,0,0,0,0,0,0,0,0,0,0,0
2018-19,Odisha,DCP BBSR,0,0,0,0,0,0,0,0,0,0,0,0,0,0,0,0,0,0,0,0,0,0,0,0,0,0,0,0,0,0,0,0
2018-19,Odisha,DCP CTC,0,0,0,0,0,0,0,0,0,0,0,0,0,0,0,0,0,0,0,0,0,0,0,0,0,0,0,0,0,0,0,0
2018-19,Odisha,Deogarh,0,0,0,0,0,0,0,0,0,0,0,0,0,0,0,0,0,0,0,0,0,0,0,0,0,0,0,0,0,0,0,0
2018-19,Odisha,Dhenkanal,0,0,0,0,0,0,0,0,0,0,0,0,0,0,0,0,0,0,0,0,0,0,0,0,0,0,0,0,0,0,0,0
2018-19,Odisha,Gajapati,0,0,0,0,0,0,0,0,0,0,0,0,0,0,0,0,0,0,0,0,0,0,0,0,0,0,0,0,0,0,0,0
2018-19,Odisha,Ganjam,0,0,0,0,0,0,0,0,0,0,0,0,0,0,0,0,0,0,0,0,0,0,0,0,0,0,0,0,0,0,0,0
2018-19,Odisha,Jagatsinghpur,0,0,0,0,0,0,0,0,0,0,0,0,0,0,0,0,0,0,0,0,0,0,0,0,0,0,0,0,0,0,0,0
2018-19,Odisha,Jajpur,0,0,0,0,0,0,0,0,0,0,0,0,0,0,0,0,0,0,0,0,0,0,0,0,0,0,0,0,0,0,0,0
2018-19,Odisha,Jharsuguda,0,0,0,0,0,0,0,0,0,0,0,0,0,0,0,0,0,0,0,0,0,0,0,0,0,0,0,0,0,0,0,0
2018-19,Odisha,Kalahandi,0,0,0,0,0,0,0,0,0,0,0,0,0,0,0,0,0,0,0,0,0,0,0,0,0,0,0,0,0,0,0,0
2018-19,Odisha,Kandhamal,0,0,0,0,0,0,0,0,0,0,0,0,0,0,0,0,0,0,0,0,0,0,0,0,0,0,0,0,0,0,0,0
2018-19,Odisha,Kendrapara,0,0,0,0,0,0,0,0,0,0,0,0,0,0,0,0,0,0,0,0,0,0,0,0,0,0,0,0,0,0,0,0
2018-19,Odisha,Keonjhar,0,0,0,0,0,0,0,0,0,0,0,0,0,0,0,0,0,0,0,0,0,0,0,0,0,0,0,0,0,0,0,0
2018-19,Odisha,Khurda,0,0,0,0,0,0,0,0,0,0,0,0,0,0,0,0,0,0,0,0,0,0,0,0,0,0,0,0,0,0,0,0
2018-19,Odisha,Koraput,0,0,0,0,0,0,0,0,0,0,0,0,0,0,0,0,0,0,0,0,0,0,0,0,0,0,0,0,0,0,0,0
2018-19,Odisha,Malkangiri,0,0,0,0,0,0,0,0,0,0,0,0,0,0,0,0,0,0,0,0,0,0,0,0,0,0,0,0,0,0,0,0
2018-19,Odisha,Mayurbhanj,0,0,0,0,0,0,0,0,0,0,0,0,0,0,0,0,0,0,0,0,0,0,0,0,0,0,0,0,0,0,0,0
2018-19,Odisha,Nayagarh,0,0,0,0,0,0,0,0,0,0,0,0,0,0,0,0,0,0,0,0,0,0,0,0,0,0,0,0,0,0,0,0
2018-19,Odisha,Nabarangpur,0,0,0,0,0,0,0,0,0,0,0,0,0,0,0,0,0,0,0,0,0,0,0,0,0,0,0,0,0,0,0,0
2018-19,Odisha,Nuapada,0,0,0,0,0,0,0,0,0,0,0,0,0,0,0,0,0,0,0,0,0,0,0,0,0,0,0,0,0,0,0,0
2018-19,Odisha,Puri,0,0,0,0,0,0,0,0,0,0,0,0,0,0,0,0,0,0,0,0,0,0,0,0,0,0,0,0,0,0,0,0
2018-19,Odisha,Rayagada,0,0,0,0,0,0,0,0,0,0,0,0,0,0,0,0,0,0,0,0,0,0,0,0,0,0,0,0,0,0,0,0
2018-19,Odisha,Rourkela,0,0,0,0,0,0,0,0,0,0,0,0,0,0,0,0,0,0,0,0,0,0,0,0,0,0,0,0,0,0,0,0
2018-19,Odisha,Sambalpur,0,0,0,0,0,0,0,0,0,0,0,0,0,0,0,0,0,0,0,0,0,0,0,0,0,0,0,0,0,0,0,0
2018-19,Odisha,Sonepur,0,0,0,0,0,0,0,0,0,0,0,0,0,0,0,0,0,0,0,0,0,0,0,0,0,0,0,0,0,0,0,0
2018-19,Odisha,SRP(Cuttack),0,0,0,0,0,0,0,0,0,0,0,0,0,0,0,0,0,0,0,0,0,0,0,0,0,0,0,0,0,0,0,0
2018-19,Odisha,SRP(Rourkela),0,0,0,0,0,0,0,0,0,0,0,0,0,0,0,0,0,0,0,0,0,0,0,0,0,0,0,0,0,0,0,0
2018-19,Odisha,Sundargarh,0,0,0,0,0,0,0,0,0,0,0,0,0,0,0,0,0,0,0,0,0,0,0,0,0,0,0,0,0,0,0,0
2018-19,Odisha,CID CB,3300,45,272,243,1852,514,321,53,12017,18,654,1919,5987,2112,1322,5,0,0,0,0,0,0,0,0,15317,63,926,2162,7839,2626,1643,58
2018-19,Odisha,Total,3300,45,272,243,1852,514,321,53,12017,18,654,1919,5987,2112,1322,5,0,0,0,0,0,0,0,0,15317,63,926,2162,7839,2626,1643,58
2018-19,Punjab,Amritsar Rural,41,1,7,2,11,11,5,4,106,0,10,67,21,7,1,0,0,0,0,0,0,0,0,0,147,1,17,69,32,18,6,4
2018-19,Punjab,Barnala,22,0,2,1,8,8,2,1,35,0,1,9,16,8,1,0,0,0,0,0,0,0,0,0,57,0,3,10,24,16,3,1
2018-19,Punjab,Batala,40,0,0,0,25,9,4,2,19,0,0,0,14,2,2,1,0,0,0,0,0,0,0,0,59,0,0,0,39,11,6,3
2018-19,Punjab,Bathinda,64,0,3,8,21,17,9,6,32,0,0,5,21,2,4,0,0,0,0,0,0,0,0,0,96,0,3,13,42,19,13,6
2018-19,Punjab,CP Amritsar,122,7,10,6,32,46,15,6,159,5,11,57,62,16,4,4,0,0,0,0,0,0,0,0,281,12,21,63,94,62,19,10
2018-19,Punjab,CP Jalandhar,198,0,0,0,81,69,32,16,227,0,0,0,174,37,15,1,0,0,0,0,0,0,0,0,425,0,0,0,255,106,47,17
2018-19,Punjab,CP Ludhiana,161,8,36,17,40,43,8,9,201,3,14,53,101,23,4,3,0,0,0,0,0,0,0,0,362,11,50,70,141,66,12,12
2018-19,Punjab,Faridkot,36,0,1,0,13,13,7,2,47,0,2,26,10,6,2,1,0,0,0,0,0,0,0,0,83,0,3,26,23,19,9,3
2018-19,Punjab,Fatehgarh Sahib,37,0,3,0,8,9,12,5,22,1,0,0,12,8,0,1,0,0,0,0,0,0,0,0,59,1,3,0,20,17,12,6
2018-19,Punjab,Fazilka,63,3,7,2,19,20,9,3,48,0,5,2,32,8,1,0,0,0,0,0,0,0,0,0,111,3,12,4,51,28,10,3
2018-19,Punjab,Ferozepur,69,0,0,1,31,20,12,5,88,1,1,45,22,13,3,3,0,0,0,0,0,0,0,0,157,1,1,46,53,33,15,8
2018-19,Punjab,GRP,5,2,0,0,1,1,1,0,9,0,0,3,2,3,0,1,0,0,0,0,0,0,0,0,14,2,0,3,3,4,1,1
2018-19,Punjab,Gurdaspur,20,0,1,1,8,7,3,0,8,0,0,2,2,3,1,0,0,0,0,0,0,0,0,0,28,0,1,3,10,10,4,0
2018-19,Punjab,Hoshiarpur,113,2,3,6,19,40,31,12,220,2,2,45,98,53,12,8,0,0,0,0,0,0,0,0,333,4,5,51,117,93,43,20
2018-19,Punjab,Jalandhar Rural,136,7,7,8,37,42,23,12,232,8,7,13,154,39,10,1,0,0,0,0,0,0,0,0,368,15,14,21,191,81,33,13
2018-19,Punjab,Kapurthala,18,0,0,0,8,6,4,0,30,0,0,0,20,8,2,0,0,0,0,0,0,0,0,0,48,0,0,0,28,14,6,0
2018-19,Punjab,Khanna,67,0,5,3,15,23,15,6,50,0,2,1,38,8,1,0,0,0,0,0,0,0,0,0,117,0,7,4,53,31,16,6
2018-19,Punjab,Ludhiana Rural,21,0,0,0,6,4,7,4,8,0,0,0,5,2,1,0,0,0,0,0,0,0,0,0,29,0,0,0,11,6,8,4
2018-19,Punjab,Mansa,25,0,0,0,6,10,5,4,4,0,0,1,1,2,0,0,0,0,0,0,0,0,0,0,29,0,0,1,7,12,5,4
2018-19,Punjab,Moga,59,0,2,0,14,26,8,9,37,0,1,0,22,9,4,1,0,0,0,0,0,0,0,0,96,0,3,0,36,35,12,10
2018-19,Punjab,Muktsar,72,3,4,3,22,26,10,4,29,0,2,2,15,9,1,0,0,0,0,0,0,0,0,0,101,3,6,5,37,35,11,4
2018-19,Punjab,Pathankot,15,0,0,0,6,8,0,1,13,0,1,2,9,1,0,0,0,0,0,0,0,0,0,0,28,0,1,2,15,9,0,1
2018-19,Punjab,Patiala,63,3,15,10,14,12,4,5,202,2,15,109,58,16,2,0,0,0,0,0,0,0,0,0,265,5,30,119,72,28,6,5
2018-19,Punjab,Ropar,48,1,7,2,14,9,10,5,41,0,4,21,6,7,2,1,0,0,0,0,0,0,0,0,89,1,11,23,20,16,12,6
2018-19,Punjab,Sangrur,49,3,11,11,9,10,3,2,119,1,7,66,38,5,2,0,0,0,0,0,0,0,0,0,168,4,18,77,47,15,5,2
2018-19,Punjab,SAS Nagar,46,0,0,0,19,20,5,2,46,0,0,0,38,8,0,0,0,0,0,0,0,0,0,0,92,0,0,0,57,28,5,2
2018-19,Punjab,SBS Nagar,31,0,4,0,6,15,2,4,28,1,1,2,17,6,1,0,0,0,0,0,0,0,0,0,59,1,5,2,23,21,3,4
2018-19,Punjab,Tarn Taran,39,0,0,2,10,11,12,4,19,0,0,2,7,6,3,1,0,0,0,0,0,0,0,0,58,0,0,4,17,17,15,5
2018-19,Punjab,Bureau of Investigation,0,0,0,0,0,0,0,0,0,0,0,0,0,0,0,0,0,0,0,0,0,0,0,0,0,0,0,0,0,0,0,0
2018-19,Punjab,Intelligence Wing,0,0,0,0,0,0,0,0,0,0,0,0,0,0,0,0,0,0,0,0,0,0,0,0,0,0,0,0,0,0,0,0
2018-19,Punjab,NRI Wing,0,0,0,0,0,0,0,0,0,0,0,0,0,0,0,0,0,0,0,0,0,0,0,0,0,0,0,0,0,0,0,0
2018-19,Punjab,Special Task Force,0,0,0,0,0,0,0,0,0,0,0,0,0,0,0,0,0,0,0,0,0,0,0,0,0,0,0,0,0,0,0,0
2018-19,Punjab,Total,1680,40,128,83,503,535,258,133,2079,24,86,533,1015,315,79,27,0,0,0,0,0,0,0,0,3759,64,214,616,1518,850,337,160
2018-19,Rajasthan,Ajmer,328,6,18,35,142,80,36,11,1064,12,30,197,512,284,25,4,0,0,0,0,0,0,0,0,1392,18,48,232,654,364,61,15
2018-19,Rajasthan,Alwar,173,2,7,16,67,44,31,6,262,5,7,22,135,67,24,2,0,0,0,0,0,0,0,0,435,7,14,38,202,111,55,8
2018-19,Rajasthan,Banswara,81,1,4,3,37,23,11,2,291,0,4,12,172,88,13,2,0,0,0,0,0,0,0,0,372,1,8,15,209,111,24,4
2018-19,Rajasthan,Baran,118,0,1,9,58,37,8,5,453,0,5,71,289,79,7,2,0,0,0,0,0,0,0,0,571,0,6,80,347,116,15,7
2018-19,Rajasthan,Barmer,73,0,5,4,45,14,5,0,202,0,10,43,128,19,2,0,0,0,0,0,0,0,0,0,275,0,15,47,173,33,7,0
2018-19,Rajasthan,Bharatpur,121,0,9,14,35,34,25,4,164,0,8,11,81,44,14,6,0,0,0,0,0,0,0,0,285,0,17,25,116,78,39,10
2018-19,Rajasthan,Bhilwara,231,2,10,22,97,58,28,14,974,2,19,210,618,104,14,7,0,0,0,0,0,0,0,0,1205,4,29,232,715,162,42,21
2018-19,Rajasthan,Bikaner,11,0,5,0,6,0,0,0,97,0,0,0,66,31,0,0,0,0,0,0,0,0,0,0,108,0,5,0,72,31,0,0
2018-19,Rajasthan,Bundi,108,0,4,9,55,29,9,2,565,0,26,125,360,44,7,3,0,0,0,0,0,0,0,0,673,0,30,134,415,73,16,5
2018-19,Rajasthan,Chittorgarh,164,0,0,1,81,59,20,3,662,0,0,37,447,158,17,3,0,0,0,0,0,0,0,0,826,0,0,38,528,217,37,6
2018-19,Rajasthan,Churu,98,0,4,20,16,34,14,10,229,1,10,30,165,21,2,0,0,0,0,0,0,0,0,0,327,1,14,50,181,55,16,10
2018-19,Rajasthan,Dausa,98,0,13,13,38,19,11,4,149,0,7,16,75,43,6,2,0,0,0,0,0,0,0,0,247,0,20,29,113,62,17,6
2018-19,Rajasthan,Dholpur,47,5,5,2,19,7,5,4,79,4,3,1,47,23,0,1,0,0,0,0,0,0,0,0,126,9,8,3,66,30,5,5
2018-19,Rajasthan,Dungarpur,53,0,0,3,29,13,6,2,337,0,9,40,229,53,6,0,0,0,0,0,0,0,0,0,390,0,9,43,258,66,12,2
2018-19,Rajasthan,GRP Ajmer,30,1,0,0,13,9,5,2,13,0,0,0,6,2,2,3,0,0,0,0,0,0,0,0,43,1,0,0,19,11,7,5
2018-19,Rajasthan,GRP Jodhpur,8,0,0,0,3,1,2,2,4,0,0,0,2,1,1,0,0,0,0,0,0,0,0,0,12,0,0,0,5,2,3,2
2018-19,Rajasthan,Ganganagar,223,0,6,16,107,66,21,7,534,0,3,27,428,72,3,1,0,0,0,0,0,0,0,0,757,0,9,43,535,138,24,8
2018-19,Rajasthan,Hanumangarh,153,1,8,8,49,50,28,9,456,1,11,78,257,93,12,4,0,0,0,0,0,0,0,0,609,2,19,86,306,143,40,13
2018-19,Rajasthan,Jaipur East,315,3,10,9,140,89,43,21,375,0,6,37,266,54,6,6,0,0,0,0,0,0,0,0,690,3,16,46,406,143,49,27
2018-19,Rajasthan,Jaipur North,297,1,26,23,89,96,51,11,430,1,18,72,243,78,14,4,0,0,0,0,0,0,0,0,727,2,44,95,332,174,65,15
2018-19,Rajasthan,Jaipur Rural,169,0,17,18,72,41,16,5,315,0,2,38,212,58,4,1,0,0,0,0,0,0,0,0,484,0,19,56,284,99,20,6
2018-19,Rajasthan,Jaipur South,204,0,5,22,83,48,32,14,310,0,8,47,184,60,8,3,0,0,0,0,0,0,0,0,514,0,13,69,267,108,40,17
2018-19,Rajasthan,Jaipur West,438,1,21,43,210,109,50,4,599,2,30,97,301,165,4,0,0,0,0,0,0,0,0,0,1037,3,51,140,511,274,54,4
2018-19,Rajasthan,Jaisalmer,34,0,1,6,13,7,5,2,47,0,4,10,31,2,0,0,0,0,0,0,0,0,0,0,81,0,5,16,44,9,5,2
2018-19,Rajasthan,Jalore,74,1,5,7,35,19,4,3,353,0,15,64,246,20,7,1,0,0,0,0,0,0,0,0,427,1,20,71,281,39,11,4
2018-19,Rajasthan,Jhalawar,162,2,8,17,61,50,14,10,549,1,16,124,343,55,5,5,0,0,0,0,0,0,0,0,711,3,24,141,404,105,19,15
2018-19,Rajasthan,Jhunjhunu,173,1,14,21,68,35,22,12,490,1,8,72,363,39,7,0,0,0,0,0,0,0,0,0,663,2,22,93,431,74,29,12
2018-19,Rajasthan,Jodhpur East,155,0,5,14,58,48,19,11,260,0,9,44,134,61,9,3,0,0,0,0,0,0,0,0,415,0,14,58,192,109,28,14
2018-19,Rajasthan,Jodhpur West,195,2,10,13,90,57,16,7,327,1,17,45,207,47,9,1,0,0,0,0,0,0,0,0,522,3,27,58,297,104,25,8
2018-19,Rajasthan,Jodhpur Rural,66,0,3,13,31,9,6,4,162,0,10,48,90,13,1,0,0,0,0,0,0,0,0,0,228,0,13,61,121,22,7,4
2018-19,Rajasthan,Karauli,52,0,2,8,24,7,5,6,89,0,2,2,63,18,4,0,0,0,0,0,0,0,0,0,141,0,4,10,87,25,9,6
2018-19,Rajasthan,Kota City,416,0,21,54,170,106,45,20,788,1,31,132,464,125,24,11,0,0,0,0,0,0,0,0,1204,1,52,186,634,231,69,31
2018-19,Rajasthan,Kota Rural,76,1,3,6,41,19,5,1,460,0,15,98,301,42,3,1,0,0,0,0,0,0,0,0,536,1,18,104,342,61,8,2
2018-19,Rajasthan,Nagaur,130,0,8,17,26,49,30,0,546,0,27,80,279,116,29,15,0,0,0,0,0,0,0,0,676,0,35,97,305,165,59,15
2018-19,Rajasthan,Pali,28,0,2,4,14,5,3,0,206,0,4,41,135,25,1,0,0,0,0,0,0,0,0,0,234,0,6,45,149,30,4,0
2018-19,Rajasthan,Pratapgarh,52,0,0,0,38,12,2,0,194,0,0,1,172,20,0,1,0,0,0,0,0,0,0,0,246,0,0,1,210,32,2,1
2018-19,Rajasthan,Rajsamand,109,0,2,5,63,19,17,3,706,0,9,107,535,43,9,3,0,0,0,0,0,0,0,0,815,0,11,112,598,62,26,6
2018-19,Rajasthan,Sawai Madhopur,80,0,13,14,27,13,10,3,160,0,0,6,121,25,7,1,0,0,0,0,0,0,0,0,240,0,13,20,148,38,17,4
2018-19,Rajasthan,Sikar,232,0,9,31,92,59,32,9,485,3,7,65,357,46,5,2,0,0,0,0,0,0,0,0,717,3,16,96,449,105,37,11
2018-19,Rajasthan,Sirohi,75,0,1,14,34,15,6,5,292,0,3,21,236,27,5,0,0,0,0,0,0,0,0,0,367,0,4,35,270,42,11,5
2018-19,Rajasthan,Tonk,78,0,4,9,32,19,7,7,289,0,3,19,202,54,6,5,0,0,0,0,0,0,0,0,367,0,7,28,234,73,13,12
2018-19,Rajasthan,Udaipur,256,0,0,5,104,98,38,11,901,0,6,49,624,183,31,8,0,0,0,0,0,0,0,0,1157,0,6,54,728,281,69,19
2018-19,Rajasthan,Jaipur Metro,0,0,0,0,0,0,0,0,0,0,0,0,0,0,0,0,0,0,0,0,0,0,0,0,0,0,0,0,0,0,0,0
2018-19,Rajasthan,SCRB,0,0,0,0,0,0,0,0,0,0,0,0,0,0,0,0,0,0,0,0,0,0,0,0,0,0,0,0,0,0,0,0
2018-19,Rajasthan,SOG,0,0,0,0,0,0,0,0,0,0,0,0,0,0,0,0,0,0,0,0,0,0,0,0,0,0,0,0,0,0,0,0
2018-19,Rajasthan,SSB,0,0,0,0,0,0,0,0,0,0,0,0,0,0,0,0,0,0,0,0,0,0,0,0,0,0,0,0,0,0,0,0
2018-19,Rajasthan,Jaipur Crime,0,0,0,0,0,0,0,0,0,0,0,0,0,0,0,0,0,0,0,0,0,0,0,0,0,0,0,0,0,0,0,0
2018-19,Rajasthan,Bhiwadi,154,1,12,14,45,38,38,6,287,0,24,61,131,61,9,1,0,0,0,0,0,0,0,0,441,1,36,75,176,99,47,7
2018-19,Rajasthan,Total,6138,31,301,562,2557,1644,781,262,16155,35,426,2300,10257,2663,362,112,0,0,0,0,0,0,0,0,22293,66,727,2862,12814,4307,1143,374
2018-19,Sikkim,East,37,2,1,10,4,17,3,0,91,0,1,19,50,19,2,0,0,0,0,0,0,0,0,0,128,2,2,29,54,36,5,0
2018-19,Sikkim,North,2,0,0,0,2,0,0,0,1,0,0,1,0,0,0,0,0,0,0,0,0,0,0,0,3,0,0,1,2,0,0,0
2018-19,Sikkim,South,5,0,0,0,1,1,3,0,11,0,3,0,8,0,0,0,0,0,0,0,0,0,0,0,16,0,3,0,9,1,3,0
2018-19,Sikkim,West,16,0,0,0,6,6,3,1,33,0,0,1,23,9,0,0,0,0,0,0,0,0,0,0,49,0,0,1,29,15,3,1
2018-19,Sikkim,Total,60,2,1,10,13,24,9,1,136,0,4,21,81,28,2,0,0,0,0,0,0,0,0,0,196,2,5,31,94,52,11,1
2018-19,Tamil Nadu,Ariyalur,35,4,2,7,7,3,4,8,140,7,3,25,84,16,4,1,0,0,0,0,0,0,0,0,175,11,5,32,91,19,8,9
2018-19,Tamil Nadu,Chennai,1328,42,84,126,284,334,208,250,2139,43,87,447,1121,222,80,139,2,0,0,0,1,1,0,0,3469,85,171,573,1406,557,288,389
2018-19,Tamil Nadu,Coimbatore,140,0,1,15,31,41,32,20,397,0,6,115,105,130,26,15,0,0,0,0,0,0,0,0,537,0,7,130,136,171,58,35
2018-19,Tamil Nadu,Coimbatore City,164,8,9,19,23,51,28,26,295,8,19,84,123,45,8,8,0,0,0,0,0,0,0,0,459,16,28,103,146,96,36,34
2018-19,Tamil Nadu,Cuddalore,81,0,4,8,18,26,18,7,271,0,1,52,149,53,8,8,0,0,0,0,0,0,0,0,352,0,5,60,167,79,26,15
2018-19,Tamil Nadu,Dharmapuri,35,0,5,8,8,5,4,5,87,2,4,44,27,5,3,2,0,0,0,0,0,0,0,0,122,2,9,52,35,10,7,7
2018-19,Tamil Nadu,Dindigul,98,8,9,17,18,24,11,11,209,9,10,74,71,33,9,3,0,0,0,0,0,0,0,0,307,17,19,91,89,57,20,14
2018-19,Tamil Nadu,Erode,133,7,16,14,22,37,20,17,374,9,18,77,218,29,7,16,0,0,0,0,0,0,0,0,507,16,34,91,240,66,27,33
2018-19,Tamil Nadu,Kanchipuram,281,0,20,23,126,72,26,14,647,0,24,98,225,154,124,22,0,0,0,0,0,0,0,0,928,0,44,121,351,226,150,36
2018-19,Tamil Nadu,Kanyakumari,162,14,8,12,34,41,32,21,263,10,11,7,190,31,6,8,0,0,0,0,0,0,0,0,425,24,19,19,224,72,38,29
2018-19,Tamil Nadu,Karur,36,1,3,3,10,7,7,5,139,0,2,46,74,11,2,4,0,0,0,0,0,0,0,0,175,1,5,49,84,18,9,9
2018-19,Tamil Nadu,Krishnagiri,60,3,6,10,17,12,9,3,139,8,9,25,77,10,8,2,0,0,0,0,0,0,0,0,199,11,15,35,94,22,17,5
2018-19,Tamil Nadu,Madurai,117,11,15,9,18,33,17,14,342,18,6,68,182,59,8,1,0,0,0,0,0,0,0,0,459,29,21,77,200,92,25,15
2018-19,Tamil Nadu,Madurai City,185,17,19,26,31,43,29,20,393,15,22,65,206,53,18,14,0,0,0,0,0,0,0,0,578,32,41,91,237,96,47,34
2018-19,Tamil Nadu,Nagapattinam,49,6,5,8,7,12,6,5,177,7,8,39,74,39,7,3,0,0,0,0,0,0,0,0,226,13,13,47,81,51,13,8
2018-19,Tamil Nadu,Namakkal,46,5,4,4,6,14,8,5,79,3,10,15,29,15,7,0,0,0,0,0,0,0,0,0,125,8,14,19,35,29,15,5
2018-19,Tamil Nadu,Nilgiris,20,0,1,3,8,3,4,1,37,5,0,14,15,2,1,0,0,0,0,0,0,0,0,0,57,5,1,17,23,5,5,1
2018-19,Tamil Nadu,Perambalur,23,2,2,2,8,4,2,3,136,4,6,47,68,6,3,2,0,0,0,0,0,0,0,0,159,6,8,49,76,10,5,5
2018-19,Tamil Nadu,Pudukottai,40,0,0,5,12,11,7,5,169,0,0,38,112,15,1,3,0,0,0,0,0,0,0,0,209,0,0,43,124,26,8,8
2018-19,Tamil Nadu,Ramnathapuram,79,8,11,5,4,21,22,8,218,11,15,30,112,46,2,2,0,0,0,0,0,0,0,0,297,19,26,35,116,67,24,10
2018-19,Tamil Nadu,Railway Chennai,33,0,2,1,3,12,8,7,23,1,0,3,8,3,3,5,0,0,0,0,0,0,0,0,56,1,2,4,11,15,11,12
2018-19,Tamil Nadu,Railway Trichy,8,0,0,0,2,0,1,5,3,0,0,0,1,0,0,2,0,0,0,0,0,0,0,0,11,0,0,0,3,0,1,7
2018-19,Tamil Nadu,Salem,70,0,5,8,13,16,19,9,224,0,8,77,74,27,22,16,0,0,0,0,0,0,0,0,294,0,13,85,87,43,41,25
2018-19,Tamil Nadu,Salem City,69,2,7,7,21,15,12,5,108,4,5,32,44,7,8,8,0,0,0,0,0,0,0,0,177,6,12,39,65,22,20,13
2018-19,Tamil Nadu,Sivagangai,50,2,7,5,8,10,12,6,133,6,11,31,59,21,2,3,0,0,0,0,0,0,0,0,183,8,18,36,67,31,14,9
2018-19,Tamil Nadu,Thanjavur,103,12,11,4,20,23,15,18,259,12,13,62,136,26,4,6,0,0,0,0,0,0,0,0,362,24,24,66,156,49,19,24
2018-19,Tamil Nadu,Theni,73,10,10,12,9,14,9,9,171,3,14,58,49,33,8,6,0,0,0,0,0,0,0,0,244,13,24,70,58,47,17,15
2018-19,Tamil Nadu,Thirunelveli,201,16,22,27,28,51,33,24,458,22,25,112,192,83,13,11,0,0,0,0,0,0,0,0,659,38,47,139,220,134,46,35
2018-19,Tamil Nadu,Thirunelveli City,39,3,3,4,3,14,8,4,88,2,2,22,55,3,3,1,0,0,0,0,0,0,0,0,127,5,5,26,58,17,11,5
2018-19,Tamil Nadu,Thiruvallur,187,16,23,14,48,48,19,19,561,18,19,110,366,37,6,5,0,0,0,0,0,0,0,0,748,34,42,124,414,85,25,24
2018-19,Tamil Nadu,Thiruvannamalai,103,12,13,14,24,15,12,13,312,12,17,72,187,12,1,11,0,0,0,0,0,0,0,0,415,24,30,86,211,27,13,24
2018-19,Tamil Nadu,Thiruvarur,31,2,5,3,7,9,1,4,122,3,4,18,78,14,2,3,0,0,0,0,0,0,0,0,153,5,9,21,85,23,3,7
2018-19,Tamil Nadu,Thoothukudi,108,14,8,19,16,25,9,17,255,10,4,74,136,26,1,4,0,0,0,0,0,0,0,0,363,24,12,93,152,51,10,21
2018-19,Tamil Nadu,Tiruppur,96,4,4,7,21,22,17,21,297,15,9,72,147,34,7,13,0,0,0,0,0,0,0,0,393,19,13,79,168,56,24,34
2018-19,Tamil Nadu,Tiruppur City,102,4,1,11,28,30,18,10,194,6,6,70,95,9,1,7,0,0,0,0,0,0,0,0,296,10,7,81,123,39,19,17
2018-19,Tamil Nadu,Trichy,50,2,7,5,8,13,8,7,119,8,1,16,66,19,3,6,0,0,0,0,0,0,0,0,169,10,8,21,74,32,11,13
2018-19,Tamil Nadu,Trichy City,84,2,5,13,16,22,14,12,128,2,4,29,76,5,6,6,0,0,0,0,0,0,0,0,212,4,9,42,92,27,20,18
2018-19,Tamil Nadu,Vellore,217,13,24,25,26,45,44,40,618,20,28,149,297,99,12,13,0,0,0,0,0,0,0,0,835,33,52,174,323,144,56,53
2018-19,Tamil Nadu,Villupuram,114,0,4,19,29,24,9,29,309,0,5,86,173,31,7,7,0,0,0,0,0,0,0,0,423,0,9,105,202,55,16,36
2018-19,Tamil Nadu,Virudhunagar,106,7,20,11,25,23,11,9,247,15,4,63,132,24,4,5,0,0,0,0,0,0,0,0,353,22,24,74,157,47,15,14
2018-19,Tamil Nadu,Cyber Cell,0,0,0,0,0,0,0,0,0,0,0,0,0,0,0,0,0,0,0,0,0,0,0,0,0,0,0,0,0,0,0,0
2018-19,Tamil Nadu,Other Units,0,0,0,0,0,0,0,0,0,0,0,0,0,0,0,0,0,0,0,0,0,0,0,0,0,0,0,0,0,0,0,0
2018-19,Tamil Nadu,Total,4956,257,405,533,1047,1225,773,716,11280,318,440,2566,5633,1487,445,391,2,0,0,0,1,1,0,0,16238,575,845,3099,6681,2713,1218,1107
2018-19,Telangana,Cyberabad Commissionerate,1478,36,78,120,396,427,301,120,1829,25,66,62,509,431,498,238,0,0,0,0,0,0,0,0,3307,61,144,182,905,858,799,358
2018-19,Telangana,Hyderabad Commissionerate,1661,69,152,85,655,591,97,12,2323,98,183,309,875,697,85,76,0,0,0,0,0,0,0,0,3984,167,335,394,1530,1288,182,88
2018-19,Telangana,Karimnagar Commissionerate,113,7,4,9,23,40,20,10,306,10,21,43,168,50,12,2,0,0,0,0,0,0,0,0,419,17,25,52,191,90,32,12
2018-19,Telangana,Khammam Commissionerate,128,2,7,4,54,37,17,7,275,2,6,3,211,33,15,5,0,0,0,0,0,0,0,0,403,4,13,7,265,70,32,12
2018-19,Telangana,Nizamabad Commissionerate,208,17,22,15,63,47,25,19,399,11,12,62,261,30,12,11,0,0,0,0,0,0,0,0,607,28,34,77,324,77,37,30
2018-19,Telangana,Rachakonda Commissionerate,1149,5,93,140,281,372,202,56,1482,10,35,156,746,354,128,53,0,0,0,0,0,0,0,0,2631,15,128,296,1027,726,330,109
2018-19,Telangana,Ramagundam Commissionerate,117,0,1,8,39,47,18,4,328,0,2,23,261,33,6,3,0,0,0,0,0,0,0,0,445,0,3,31,300,80,24,7
2018-19,Telangana,Siddipet Commissionerate,126,3,9,9,33,37,27,8,266,5,9,39,135,71,6,1,0,0,0,0,0,0,0,0,392,8,18,48,168,108,33,9
2018-19,Telangana,Warangal Commissionerate,248,13,15,42,36,72,50,20,583,10,18,102,317,105,18,13,0,0,0,0,0,0,0,0,831,23,33,144,353,177,68,33
2018-19,Telangana,Adilabad,43,2,3,5,15,10,4,4,76,1,5,3,57,8,1,1,0,0,0,0,0,0,0,0,119,3,8,8,72,18,5,5
2018-19,Telangana,Bhadradri Kothagudem,66,2,7,0,24,21,6,6,181,8,5,0,136,27,5,0,0,0,0,0,0,0,0,0,247,10,12,0,160,48,11,6
2018-19,Telangana,Jagityal,42,0,2,0,40,0,0,0,157,0,25,132,0,0,0,0,0,0,0,0,0,0,0,0,199,0,27,132,40,0,0,0
2018-19,Telangana,Jayashankar Bhupalpalli,20,0,1,3,2,5,7,2,64,0,1,5,43,8,7,0,0,0,0,0,0,0,0,0,84,0,2,8,45,13,14,2
2018-19,Telangana,Jogulamba Gadwal,47,0,5,9,16,11,6,0,72,0,5,19,40,4,2,2,0,0,0,0,0,0,0,0,119,0,10,28,56,15,8,2
2018-19,Telangana,Kamareddy,102,8,9,6,24,33,12,10,201,11,9,13,109,46,10,3,0,0,0,0,0,0,0,0,303,19,18,19,133,79,22,13
2018-19,Telangana,Kumaram Bheem Asifabad,39,0,1,5,16,9,4,4,50,0,0,3,33,12,2,0,0,0,0,0,0,0,0,0,89,0,1,8,49,21,6,4
2018-19,Telangana,Mahabubabad,47,2,3,4,15,13,4,6,82,0,1,0,69,11,0,1,0,0,0,0,0,0,0,0,129,2,4,4,84,24,4,7
2018-19,Telangana,Mahabubnagar,94,5,13,7,15,29,21,4,205,3,7,20,121,42,7,5,0,0,0,0,0,0,0,0,299,8,20,27,136,71,28,9
2018-19,Telangana,Medak,65,5,7,7,22,14,6,4,163,2,8,19,117,13,2,2,0,0,0,0,0,0,0,0,228,7,15,26,139,27,8,6
2018-19,Telangana,Nagarkurnool,40,5,4,6,3,14,2,6,105,3,8,17,52,20,3,2,0,0,0,0,0,0,0,0,145,8,12,23,55,34,5,8
2018-19,Telangana,Nalgonda,135,5,9,14,38,42,15,12,290,5,7,65,175,29,6,3,0,0,0,0,0,0,0,0,425,10,16,79,213,71,21,15
2018-19,Telangana,Nirmal,54,0,5,9,10,25,5,0,108,3,3,17,65,10,10,0,0,0,0,0,0,0,0,0,162,3,8,26,75,35,15,0
2018-19,Telangana,Rajanna Siricilla,31,0,0,2,6,15,4,4,121,0,1,28,68,14,6,4,0,0,0,0,0,0,0,0,152,0,1,30,74,29,10,8
2018-19,Telangana,Sangareddy,216,12,27,26,33,65,39,14,428,17,25,109,192,73,8,4,0,0,0,0,0,0,0,0,644,29,52,135,225,138,47,18
2018-19,Telangana,Suryapet,53,1,3,4,16,15,11,3,145,2,5,7,102,25,4,0,0,0,0,0,0,0,0,0,198,3,8,11,118,40,15,3
2018-19,Telangana,Vikarabad,53,0,1,16,13,8,12,3,157,0,1,30,112,12,1,1,0,0,0,0,0,0,0,0,210,0,2,46,125,20,13,4
2018-19,Telangana,Wanaparthy,35,0,8,7,15,3,2,0,144,0,0,53,58,26,7,0,0,0,0,0,0,0,0,0,179,0,8,60,73,29,9,0
2018-19,Telangana,Railway Police Secunderabad,39,0,0,1,14,15,3,6,19,0,1,2,10,1,1,4,0,0,0,0,0,0,0,0,58,0,1,3,24,16,4,10
2018-19,Telangana,Mulug,8,0,1,0,5,1,1,0,29,1,0,1,17,10,0,0,0,0,0,0,0,0,0,0,37,1,1,1,22,11,1,0
2018-19,Telangana,Narayanpet,28,0,1,2,0,20,5,0,77,0,0,15,42,20,0,0,0,0,0,0,0,0,0,0,105,0,1,17,42,40,5,0
2018-19,Telangana,Total,6485,199,491,565,1922,2038,926,344,10665,227,469,1357,5101,2215,862,434,0,0,0,0,0,0,0,0,17150,426,960,1922,7023,4253,1788,778
2018-19,Tripura,Dhalai,36,0,0,1,14,15,5,1,76,0,0,9,49,15,2,1,0,0,0,0,0,0,0,0,112,0,0,10,63,30,7,2
2018-19,Tripura,Gomati,57,0,0,2,30,23,2,0,139,1,0,7,103,27,1,0,0,0,0,0,0,0,0,0,196,1,0,9,133,50,3,0
2018-19,Tripura,GRP,0,0,0,0,0,0,0,0,0,0,0,0,0,0,0,0,0,0,0,0,0,0,0,0,0,0,0,0,0,0,0,0
2018-19,Tripura,Kowai,37,0,1,0,9,17,10,0,66,0,0,2,27,32,4,1,0,0,0,0,0,0,0,0,103,0,1,2,36,49,14,1
2018-19,Tripura,North,16,0,0,1,5,6,1,3,37,0,0,4,22,9,2,0,0,0,0,0,0,0,0,0,53,0,0,5,27,15,3,3
2018-19,Tripura,Sipahijala,56,0,0,1,33,16,5,1,148,0,1,13,118,15,1,0,0,0,0,0,0,0,0,0,204,0,1,14,151,31,6,1
2018-19,Tripura,South,56,3,8,2,15,21,4,3,170,3,8,17,110,28,4,0,0,0,0,0,0,0,0,0,226,6,16,19,125,49,8,3
2018-19,Tripura,Unakoti,31,0,1,1,13,11,4,1,100,1,0,11,73,14,0,1,0,0,0,0,0,0,0,0,131,1,1,12,86,25,4,2
2018-19,Tripura,West,217,4,11,6,59,96,31,10,490,6,9,35,223,192,21,4,0,0,0,0,0,0,0,0,707,10,20,41,282,288,52,14
2018-19,Tripura,Total,506,7,21,14,178,205,62,19,1226,11,18,98,725,332,35,7,0,0,0,0,0,0,0,0,1732,18,39,112,903,537,97,26
2018-19,Uttar Pradesh,Agra,196,0,11,17,95,44,19,10,161,1,2,20,93,33,7,5,0,0,0,0,0,0,0,0,357,1,13,37,188,77,26,15
2018-19,Uttar Pradesh,Aligarh,100,0,5,12,24,24,24,11,79,2,4,7,26,27,13,0,0,0,0,0,0,0,0,0,179,2,9,19,50,51,37,11
2018-19,Uttar Pradesh,Prayagraj,177,0,27,10,81,36,16,7,206,0,17,54,104,22,4,5,0,0,0,0,0,0,0,0,383,0,44,64,185,58,20,12
2018-19,Uttar Pradesh,Ambedkar Nagar,26,0,3,3,6,9,5,0,43,0,3,14,21,4,1,0,0,0,0,0,0,0,0,0,69,0,6,17,27,13,6,0
2018-19,Uttar Pradesh,Amethi,23,0,3,3,10,1,5,1,40,0,1,13,18,7,1,0,0,0,0,0,0,0,0,0,63,0,4,16,28,8,6,1
2018-19,Uttar Pradesh,Amroha,38,0,5,1,13,6,10,3,51,0,1,9,30,9,2,0,0,0,0,0,0,0,0,0,89,0,6,10,43,15,12,3
2018-19,Uttar Pradesh,Auraiya,18,0,4,2,5,4,3,0,39,0,4,19,13,1,0,2,0,0,0,0,0,0,0,0,57,0,8,21,18,5,3,2
2018-19,Uttar Pradesh,Azamgarh,121,3,16,10,25,32,20,15,152,2,10,19,82,26,9,4,0,0,0,0,0,0,0,0,273,5,26,29,107,58,29,19
2018-19,Uttar Pradesh,Badaun,56,0,6,6,23,14,5,2,72,1,3,28,31,5,1,3,0,0,0,0,0,0,0,0,128,1,9,34,54,19,6,5
2018-19,Uttar Pradesh,Baghpat,68,0,6,1,33,16,8,4,86,0,1,10,59,13,1,2,0,0,0,0,0,0,0,0,154,0,7,11,92,29,9,6
2018-19,Uttar Pradesh,Bahraich,30,0,3,0,15,5,4,3,35,0,6,2,18,6,1,2,0,0,0,0,0,0,0,0,65,0,9,2,33,11,5,5
2018-19,Uttar Pradesh,Ballia,59,0,7,7,16,9,9,11,62,0,5,5,24,15,11,2,0,0,0,0,0,0,0,0,121,0,12,12,40,24,20,13
2018-19,Uttar Pradesh,Balrampur,37,0,5,7,14,3,4,4,39,0,2,12,14,7,4,0,0,0,0,0,0,0,0,0,76,0,7,19,28,10,8,4
2018-19,Uttar Pradesh,Banda,12,0,0,2,9,1,0,0,30,0,0,3,23,3,1,0,0,0,0,0,0,0,0,0,42,0,0,5,32,4,1,0
2018-19,Uttar Pradesh,Barabanki,56,1,6,10,21,5,10,3,44,2,6,16,14,4,1,1,0,0,0,0,0,0,0,0,100,3,12,26,35,9,11,4
2018-19,Uttar Pradesh,Bareilly,65,0,8,6,31,18,2,0,67,0,12,5,26,23,1,0,0,0,0,0,0,0,0,0,132,0,20,11,57,41,3,0
2018-19,Uttar Pradesh,Basti,38,0,5,0,14,7,9,3,70,0,5,15,35,13,1,1,0,0,0,0,0,0,0,0,108,0,10,15,49,20,10,4
2018-19,Uttar Pradesh,Bijnor,97,0,8,10,45,17,13,4,92,1,4,12,63,11,0,1,0,0,0,0,0,0,0,0,189,1,12,22,108,28,13,5
2018-19,Uttar Pradesh,Bulandshahar,142,2,7,6,51,40,30,6,124,0,2,13,62,38,7,2,0,0,0,0,0,0,0,0,266,2,9,19,113,78,37,8
2018-19,Uttar Pradesh,Chandoli,88,0,2,5,36,21,14,10,108,0,4,12,73,12,5,2,0,0,0,0,0,0,0,0,196,0,6,17,109,33,19,12
2018-19,Uttar Pradesh,Chitrakoot,0,0,0,0,0,0,0,0,10,0,4,6,0,0,0,0,0,0,0,0,0,0,0,0,10,0,4,6,0,0,0,0
2018-19,Uttar Pradesh,Deoria,0,0,0,0,0,0,0,0,0,0,0,0,0,0,0,0,0,0,0,0,0,0,0,0,0,0,0,0,0,0,0,0
2018-19,Uttar Pradesh,Etah,45,0,5,4,9,14,10,3,54,0,3,13,21,15,2,0,0,0,0,0,0,0,0,0,99,0,8,17,30,29,12,3
2018-19,Uttar Pradesh,Etawah,43,0,4,12,11,9,3,4,76,0,5,18,32,18,2,1,0,0,0,0,0,0,0,0,119,0,9,30,43,27,5,5
2018-19,Uttar Pradesh,Ayodhya,43,0,4,7,14,11,6,1,72,0,4,11,32,22,2,1,0,0,0,0,0,0,0,0,115,0,8,18,46,33,8,2
2018-19,Uttar Pradesh,Fatehgarh,41,0,7,2,15,13,2,2,39,0,0,13,13,9,4,0,0,0,0,0,0,0,0,0,80,0,7,15,28,22,6,2
2018-19,Uttar Pradesh,Fatehpur,54,0,1,4,27,12,5,5,119,1,3,13,79,17,3,3,0,0,0,0,0,0,0,0,173,1,4,17,106,29,8,8
2018-19,Uttar Pradesh,Firozabad,46,1,6,4,12,10,8,5,40,0,3,12,19,4,2,0,0,0,0,0,0,0,0,0,86,1,9,16,31,14,10,5
2018-19,Uttar Pradesh,GRP,78,1,0,0,16,28,17,16,56,1,0,2,16,21,12,4,0,0,0,0,0,0,0,0,134,2,0,2,32,49,29,20
2018-19,Uttar Pradesh,Gautambudh Nagar,231,4,22,12,61,66,49,17,316,1,19,36,173,79,7,1,0,0,0,0,0,0,0,0,547,5,41,48,234,145,56,18
2018-19,Uttar Pradesh,Ghaziabad,222,3,17,19,88,60,23,12,171,1,15,44,83,20,6,2,0,0,0,0,0,0,0,0,393,4,32,63,171,80,29,14
2018-19,Uttar Pradesh,Ghazipur,44,0,4,1,24,7,5,3,75,0,4,14,49,6,1,1,0,0,0,0,0,0,0,0,119,0,8,15,73,13,6,4
2018-19,Uttar Pradesh,Gonda,41,0,0,3,12,16,5,5,63,0,0,6,30,16,6,5,0,0,0,0,0,0,0,0,104,0,0,9,42,32,11,10
2018-19,Uttar Pradesh,Gorakhpur,146,0,44,45,18,39,0,0,233,0,0,190,16,15,12,0,0,0,0,0,0,0,0,0,379,0,44,235,34,54,12,0
2018-19,Uttar Pradesh,Hamirpur,2,0,0,0,2,0,0,0,54,0,4,18,20,8,4,0,0,0,0,0,0,0,0,0,56,0,4,18,22,8,4,0
2018-19,Uttar Pradesh,Hapur,73,1,4,3,23,22,15,5,103,0,3,18,57,15,5,5,0,0,0,0,0,0,0,0,176,1,7,21,80,37,20,10
2018-19,Uttar Pradesh,Hardoi,0,0,0,0,0,0,0,0,0,0,0,0,0,0,0,0,0,0,0,0,0,0,0,0,0,0,0,0,0,0,0,0
2018-19,Uttar Pradesh,Hathras,23,0,2,2,10,4,4,1,35,0,0,1,25,9,0,0,0,0,0,0,0,0,0,0,58,0,2,3,35,13,4,1
2018-19,Uttar Pradesh,Jalaun,39,0,0,6,12,12,5,4,41,0,0,8,25,8,0,0,0,0,0,0,0,0,0,0,80,0,0,14,37,20,5,4
2018-19,Uttar Pradesh,Jaunpur,28,0,3,3,10,6,2,4,58,0,3,14,29,10,1,1,0,0,0,0,0,0,0,0,86,0,6,17,39,16,3,5
2018-19,Uttar Pradesh,Jhansi,6,0,1,5,0,0,0,0,105,1,21,68,15,0,0,0,0,0,0,0,0,0,0,0,111,1,22,73,15,0,0,0
2018-19,Uttar Pradesh,Kannauj,57,1,7,13,20,7,7,2,68,0,4,11,42,8,2,1,0,0,0,0,0,0,0,0,125,1,11,24,62,15,9,3
2018-19,Uttar Pradesh,Kanpur Dehat,75,0,7,2,34,21,8,3,45,0,3,1,21,17,3,0,0,0,0,0,0,0,0,0,120,0,10,3,55,38,11,3
2018-19,Uttar Pradesh,Kanpur Nagar,197,1,44,36,42,33,28,13,217,1,19,59,92,36,7,3,0,0,0,0,0,0,0,0,414,2,63,95,134,69,35,16
2018-19,Uttar Pradesh,Kasganj,24,1,3,3,7,8,2,0,24,0,1,5,6,10,2,0,0,0,0,0,0,0,0,0,48,1,4,8,13,18,4,0
2018-19,Uttar Pradesh,Kaushambi,0,0,0,0,0,0,0,0,0,0,0,0,0,0,0,0,0,0,0,0,0,0,0,0,0,0,0,0,0,0,0,0
2018-19,Uttar Pradesh,Khiri,98,2,21,18,27,18,8,4,94,0,18,27,35,11,3,0,0,0,0,0,0,0,0,0,192,2,39,45,62,29,11,4
2018-19,Uttar Pradesh,Kushi Nagar,2,1,0,1,0,0,0,0,3,0,2,1,0,0,0,0,0,0,0,0,0,0,0,0,5,1,2,2,0,0,0,0
2018-19,Uttar Pradesh,Lalitpur,5,0,0,5,0,0,0,0,32,0,0,0,32,0,0,0,0,0,0,0,0,0,0,0,37,0,0,5,32,0,0,0
2018-19,Uttar Pradesh,Lucknow,428,0,0,250,98,47,22,11,419,0,0,260,126,24,5,4,0,0,0,0,0,0,0,0,847,0,0,510,224,71,27,15
2018-19,Uttar Pradesh,Maharajganj,16,0,1,1,8,3,2,1,39,0,5,9,17,6,2,0,0,0,0,0,0,0,0,0,55,0,6,10,25,9,4,1
2018-19,Uttar Pradesh,Mahoba,7,0,3,4,0,0,0,0,13,0,4,9,0,0,0,0,0,0,0,0,0,0,0,0,20,0,7,13,0,0,0,0
2018-19,Uttar Pradesh,Mainpuri,16,0,1,9,3,2,1,0,31,0,0,26,5,0,0,0,0,0,0,0,0,0,0,0,47,0,1,35,8,2,1,0
2018-19,Uttar Pradesh,Mathura,5,0,0,3,2,0,0,0,18,0,0,11,7,0,0,0,0,0,0,0,0,0,0,0,23,0,0,14,9,0,0,0
2018-19,Uttar Pradesh,Mau,18,0,0,0,9,4,2,3,27,0,0,2,17,6,1,1,0,0,0,0,0,0,0,0,45,0,0,2,26,10,3,4
2018-19,Uttar Pradesh,Meerut,109,0,3,5,42,29,26,4,107,0,3,3,73,16,5,7,0,0,0,0,0,0,0,0,216,0,6,8,115,45,31,11
2018-19,Uttar Pradesh,Mirzapur,59,1,4,14,28,7,5,0,92,0,3,26,48,10,4,1,0,0,0,0,0,0,0,0,151,1,7,40,76,17,9,1
2018-19,Uttar Pradesh,Moradabad,254,1,24,31,82,72,34,10,244,0,16,52,101,55,12,8,0,0,0,0,0,0,0,0,498,1,40,83,183,127,46,18
2018-19,Uttar Pradesh,Muzaffarnagar,0,0,0,0,0,0,0,0,0,0,0,0,0,0,0,0,0,0,0,0,0,0,0,0,0,0,0,0,0,0,0,0
2018-19,Uttar Pradesh,Pilibhit,67,1,3,5,17,28,9,4,49,0,2,2,25,14,5,1,0,0,0,0,0,0,0,0,116,1,5,7,42,42,14,5
2018-19,Uttar Pradesh,Pratapgarh,16,0,2,3,8,3,0,0,23,0,11,7,5,0,0,0,0,0,0,0,0,0,0,0,39,0,13,10,13,3,0,0
2018-19,Uttar Pradesh,Raibareilly,33,0,2,7,9,6,7,2,47,0,4,12,20,7,2,2,0,0,0,0,0,0,0,0,80,0,6,19,29,13,9,4
2018-19,Uttar Pradesh,Rampur,2,0,0,2,0,0,0,0,9,0,0,4,3,2,0,0,0,0,0,0,0,0,0,0,11,0,0,6,3,2,0,0
2018-19,Uttar Pradesh,Saharanpur,120,1,3,10,39,32,26,9,88,0,5,9,39,29,6,0,0,0,0,0,0,0,0,0,208,1,8,19,78,61,32,9
2018-19,Uttar Pradesh,Sambhal,22,1,2,2,9,5,1,2,23,0,4,2,10,5,1,1,0,0,0,0,0,0,0,0,45,1,6,4,19,10,2,3
2018-19,Uttar Pradesh,Sant Kabirnagar,23,0,1,1,9,3,5,4,61,0,3,27,25,6,0,0,0,0,0,0,0,0,0,0,84,0,4,28,34,9,5,4
2018-19,Uttar Pradesh,Shahjahanpur,72,0,10,7,29,13,9,4,77,0,6,17,36,14,4,0,0,0,0,0,0,0,0,0,149,0,16,24,65,27,13,4
2018-19,Uttar Pradesh,Shamli,40,1,1,2,18,10,5,3,43,0,4,3,22,11,3,0,0,0,0,0,0,0,0,0,83,1,5,5,40,21,8,3
2018-19,Uttar Pradesh,Shrawasti,11,0,0,1,9,1,0,0,5,0,0,5,0,0,0,0,0,0,0,0,0,0,0,0,16,0,0,6,9,1,0,0
2018-19,Uttar Pradesh,Sidharthnagar,34,0,5,3,7,12,3,4,27,0,2,3,15,6,0,1,0,0,0,0,0,0,0,0,61,0,7,6,22,18,3,5
2018-19,Uttar Pradesh,Sitapur,148,0,12,46,44,27,10,9,160,0,10,43,75,23,5,4,0,0,0,0,0,0,0,0,308,0,22,89,119,50,15,13
2018-19,Uttar Pradesh,Sonbhadra,70,0,12,8,23,14,8,5,110,0,8,18,67,15,1,1,0,0,0,0,0,0,0,0,180,0,20,26,90,29,9,6
2018-19,Uttar Pradesh,Bhadohi,19,0,9,10,0,0,0,0,28,0,1,27,0,0,0,0,0,0,0,0,0,0,0,0,47,0,10,37,0,0,0,0
2018-19,Uttar Pradesh,Sultanpur,17,0,0,5,4,5,1,2,35,0,0,11,20,3,1,0,0,0,0,0,0,0,0,0,52,0,0,16,24,8,2,2
2018-19,Uttar Pradesh,Unnao,69,2,12,16,16,14,7,2,83,3,7,32,21,13,5,2,0,0,0,0,0,0,0,0,152,5,19,48,37,27,12,4
2018-19,Uttar Pradesh,Varanasi,195,3,10,14,58,63,31,16,167,0,8,30,80,35,6,8,0,0,0,0,0,0,0,0,362,3,18,44,138,98,37,24
2018-19,Uttar Pradesh,Total,4980,33,463,787,1632,1128,636,301,5828,18,336,1547,2648,953,225,101,0,0,0,0,0,0,0,0,10808,51,799,2334,4280,2081,861,402
2018-19,Uttarakhand,Almora,0,0,0,0,0,0,0,0,0,0,0,0,0,0,0,0,0,0,0,0,0,0,0,0,0,0,0,0,0,0,0,0
2018-19,Uttarakhand,Bageshwar,0,0,0,0,0,0,0,0,0,0,0,0,0,0,0,0,0,0,0,0,0,0,0,0,0,0,0,0,0,0,0,0
2018-19,Uttarakhand,Chamoli,0,0,0,0,0,0,0,0,0,0,0,0,0,0,0,0,0,0,0,0,0,0,0,0,0,0,0,0,0,0,0,0
2018-19,Uttarakhand,Champawat,0,0,0,0,0,0,0,0,0,0,0,0,0,0,0,0,0,0,0,0,0,0,0,0,0,0,0,0,0,0,0,0
2018-19,Uttarakhand,Dehradun,0,0,0,0,0,0,0,0,0,0,0,0,0,0,0,0,0,0,0,0,0,0,0,0,0,0,0,0,0,0,0,0
2018-19,Uttarakhand,Haridwar,0,0,0,0,0,0,0,0,0,0,0,0,0,0,0,0,0,0,0,0,0,0,0,0,0,0,0,0,0,0,0,0
2018-19,Uttarakhand,Nainital,0,0,0,0,0,0,0,0,0,0,0,0,0,0,0,0,0,0,0,0,0,0,0,0,0,0,0,0,0,0,0,0
2018-19,Uttarakhand,Pauri Garhwal,0,0,0,0,0,0,0,0,0,0,0,0,0,0,0,0,0,0,0,0,0,0,0,0,0,0,0,0,0,0,0,0
2018-19,Uttarakhand,Pithoragarh,0,0,0,0,0,0,0,0,0,0,0,0,0,0,0,0,0,0,0,0,0,0,0,0,0,0,0,0,0,0,0,0
2018-19,Uttarakhand,Rudra Prayag,0,0,0,0,0,0,0,0,0,0,0,0,0,0,0,0,0,0,0,0,0,0,0,0,0,0,0,0,0,0,0,0
2018-19,Uttarakhand,Tehri Garhwal,1018,15,75,146,375,282,100,25,1175,23,103,177,420,272,150,30,0,0,0,0,0,0,0,0,2193,38,178,323,795,554,250,55
2018-19,Uttarakhand,Udhamsingh Nagar,0,0,0,0,0,0,0,0,0,0,0,0,0,0,0,0,0,0,0,0,0,0,0,0,0,0,0,0,0,0,0,0
2018-19,Uttarakhand,Uttarkashi,0,0,0,0,0,0,0,0,0,0,0,0,0,0,0,0,0,0,0,0,0,0,0,0,0,0,0,0,0,0,0,0
2018-19,Uttarakhand,GRP,0,0,0,0,0,0,0,0,0,0,0,0,0,0,0,0,0,0,0,0,0,0,0,0,0,0,0,0,0,0,0,0
2018-19,Uttarakhand,Total,1018,15,75,146,375,282,100,25,1175,23,103,177,420,272,150,30,0,0,0,0,0,0,0,0,2193,38,178,323,795,554,250,55
2018-19,West Bengal,Alipurduar,299,0,9,17,76,131,52,14,720,1,8,139,284,229,50,9,0,0,0,0,0,0,0,0,1019,1,17,156,360,360,102,23
2018-19,West Bengal,Asansol-Durgapur PC,523,2,13,22,145,167,118,56,697,3,9,61,366,189,46,23,0,0,0,0,0,0,0,0,1220,5,22,83,511,356,164,79
2018-19,West Bengal,Bankura,373,1,10,19,96,131,77,39,674,0,7,84,364,157,42,20,0,0,0,0,0,0,0,0,1047,1,17,103,460,288,119,59
2018-19,West Bengal,Barrackpur PC,1377,2,53,84,276,439,353,170,1837,1,90,380,710,419,152,85,0,0,0,0,0,0,0,0,3214,3,143,464,986,858,505,255
2018-19,West Bengal,Bidhannagar PC,379,1,9,19,68,136,88,58,587,0,18,112,245,154,37,21,0,0,0,0,0,0,0,0,966,1,27,131,313,290,125,79
2018-19,West Bengal,Birbhum,238,0,5,5,68,89,49,22,405,0,5,42,211,119,23,5,0,0,0,0,0,0,0,0,643,0,10,47,279,208,72,27
2018-19,West Bengal,Coochbehar,407,0,18,22,121,154,71,21,1126,2,31,151,533,334,67,8,0,0,0,0,0,0,0,0,1533,2,49,173,654,488,138,29
2018-19,West Bengal,Dakshin Dinajpur,302,2,13,23,116,72,52,24,913,1,16,184,580,115,14,3,0,0,0,0,0,0,0,0,1215,3,29,207,696,187,66,27
2018-19,West Bengal,Darjeeling,126,0,4,6,22,53,29,12,303,0,3,31,129,123,15,2,0,0,0,0,0,0,0,0,429,0,7,37,151,176,44,14
2018-19,West Bengal,Hooghly Rural Police,434,2,11,23,96,180,84,38,972,1,21,213,441,222,53,21,0,0,0,0,0,0,0,0,1406,3,32,236,537,402,137,59
2018-19,West Bengal,Howrah GRP,74,3,1,4,28,16,13,9,28,0,0,4,16,3,4,1,0,0,0,0,0,0,0,0,102,3,1,8,44,19,17,10
2018-19,West Bengal,Howrah PC,786,7,43,58,279,202,115,82,876,8,24,129,484,137,47,47,0,0,0,0,0,0,0,0,1662,15,67,187,763,339,162,129
2018-19,West Bengal,Howrah Rural,525,0,25,19,120,180,125,56,1106,0,21,265,483,261,50,26,0,0,0,0,0,0,0,0,1631,0,46,284,603,441,175,82
2018-19,West Bengal,Jalpaiguri,359,1,10,13,113,139,60,23,816,1,4,83,448,234,31,15,0,0,0,0,0,0,0,0,1175,2,14,96,561,373,91,38
2018-19,West Bengal,Jhargram,94,0,0,6,37,27,7,17,239,0,4,47,136,30,10,12,0,0,0,0,0,0,0,0,333,0,4,53,173,57,17,29
2018-19,West Bengal,Kharagpur GRP,10,0,0,1,4,3,1,1,1,0,0,0,1,0,0,0,0,0,0,0,0,0,0,0,11,0,0,1,5,3,1,1
2018-19,West Bengal,Kolkata,2339,15,119,189,458,657,577,324,2584,25,90,551,942,577,235,164,0,0,0,0,0,0,0,0,4923,40,209,740,1400,1234,812,488
2018-19,West Bengal,Malda,536,4,37,46,153,178,80,38,1083,5,26,196,516,285,45,10,0,0,0,0,0,0,0,0,1619,9,63,242,669,463,125,48
2018-19,West Bengal,Murshidabad,654,2,14,16,223,274,91,34,1796,0,8,30,996,668,63,31,0,0,0,0,0,0,0,0,2450,2,22,46,1219,942,154,65
2018-19,West Bengal,Nadia,958,5,27,50,253,333,215,75,2468,5,32,355,1156,760,116,44,0,0,0,0,0,0,0,0,3426,10,59,405,1409,1093,331,119
2018-19,West Bengal,Paschim Medinipur,545,1,11,40,132,182,141,38,1260,1,16,333,609,237,44,20,0,0,0,0,0,0,0,0,1805,2,27,373,741,419,185,58
2018-19,West Bengal,Purab Medinipur,316,1,17,18,117,85,53,25,974,2,12,244,549,116,34,17,0,0,0,0,0,0,0,0,1290,3,29,262,666,201,87,42
2018-19,West Bengal,Purulia,155,0,3,3,74,45,23,7,273,0,4,18,203,26,12,10,0,0,0,0,0,0,0,0,428,0,7,21,277,71,35,17
2018-19,West Bengal,Sealdah GRP,17,0,3,0,7,3,3,1,28,0,1,5,16,1,2,3,0,0,0,0,0,0,0,0,45,0,4,5,23,4,5,4
2018-19,West Bengal,Siliguri GRP,6,0,0,0,2,3,0,1,3,0,0,0,2,1,0,0,0,0,0,0,0,0,0,0,9,0,0,0,4,4,0,1
2018-19,West Bengal,Siliguri PC,511,5,28,35,130,195,81,37,958,4,22,229,386,252,50,15,0,0,0,0,0,0,0,0,1469,9,50,264,516,447,131,52
2018-19,West Bengal,Uttar Dinajpur,216,2,6,18,82,62,42,4,547,0,4,39,330,150,18,6,0,0,0,0,0,0,0,0,763,2,10,57,412,212,60,10
2018-19,West Bengal,Baruipur Police,540,3,27,41,116,206,88,59,1133,3,45,256,446,268,59,56,0,0,0,0,0,0,0,0,1673,6,72,297,562,474,147,115
2018-19,West Bengal,Chandannagar PC,390,0,15,11,87,114,104,59,550,0,11,75,243,137,58,26,0,0,0,0,0,0,0,0,940,0,26,86,330,251,162,85
2018-19,West Bengal,Diamond Harbour Police,629,3,40,44,142,213,134,53,1331,4,37,311,538,320,87,34,0,0,0,0,0,0,0,0,1960,7,77,355,680,533,221,87
2018-19,West Bengal,Kalimpong,53,1,2,7,9,23,9,2,122,0,1,18,41,58,4,0,0,0,0,0,0,0,0,0,175,1,3,25,50,81,13,2
2018-19,West Bengal,Purba Bardhaman,434,1,13,26,101,164,100,29,1007,2,27,252,417,246,44,19,0,0,0,0,0,0,0,0,1441,3,40,278,518,410,144,48
2018-19,West Bengal,Sundarban Police,210,2,6,14,55,71,45,17,590,1,11,52,314,162,40,10,0,0,0,0,0,0,0,0,800,3,17,66,369,233,85,27
2018-19,West Bengal,Barasat,892,1,29,87,198,303,189,85,2236,0,45,562,875,576,121,57,0,0,0,0,0,0,0,0,3128,1,74,649,1073,879,310,142
2018-19,West Bengal,Basirhat,331,0,11,21,86,127,73,13,1056,0,17,308,399,268,55,9,0,0,0,0,0,0,0,0,1387,0,28,329,485,395,128,22
2018-19,West Bengal,Total,16038,67,632,1007,4090,5357,3342,1543,31299,70,670,5759,14409,7834,1728,829,0,0,0,0,0,0,0,0,47337,137,1302,6766,18499,13191,5070,2372
2018-19,AN Islands,South Andaman,79,3,2,5,27,24,12,6,95,3,6,24,30,23,3,6,0,0,0,0,0,0,0,0,174,6,8,29,57,47,15,12
2018-19,AN Islands,North & Middle Andaman,0,0,0,0,0,0,0,0,0,0,0,0,0,0,0,0,0,0,0,0,0,0,0,0,0,0,0,0,0,0,0,0
2018-19,AN Islands,Nicobar,0,0,0,0,0,0,0,0,0,0,0,0,0,0,0,0,0,0,0,0,0,0,0,0,0,0,0,0,0,0,0,0
2018-19,AN Islands,Total,79,3,2,5,27,24,12,6,95,3,6,24,30,23,3,6,0,0,0,0,0,0,0,0,174,6,8,29,57,47,15,12
2018-19,Chandigarh,All Districts,0,0,0,0,0,0,0,0,0,0,0,0,0,0,0,0,0,0,0,0,0,0,0,0,0,0,0,0,0,0,0,0
2018-19,Chandigarh,Chandigarh,332,4,26,37,116,82,40,27,465,4,20,111,262,47,13,8,0,0,0,0,0,0,0,0,797,8,46,148,378,129,53,35
2018-19,Chandigarh,Total,332,4,26,37,116,82,40,27,465,4,20,111,262,47,13,8,0,0,0,0,0,0,0,0,797,8,46,148,378,129,53,35
2018-19,DN Haveli,All Districts,0,0,0,0,0,0,0,0,0,0,0,0,0,0,0,0,0,0,0,0,0,0,0,0,0,0,0,0,0,0,0,0
2018-19,DN Haveli,D&N Haveli,19,0,0,0,10,4,5,0,50,0,0,3,36,10,1,0,0,0,0,0,0,0,0,0,69,0,0,3,46,14,6,0
2018-19,DN Haveli,Total,19,0,0,0,10,4,5,0,50,0,0,3,36,10,1,0,0,0,0,0,0,0,0,0,69,0,0,3,46,14,6,0
2018-19,Daman Diu,Daman,42,0,4,1,20,13,4,0,71,0,3,9,53,6,0,0,0,0,0,0,0,0,0,0,113,0,7,10,73,19,4,0
2018-19,Daman Diu,Diu,11,0,0,0,6,3,1,1,11,0,0,0,9,1,0,1,0,0,0,0,0,0,0,0,22,0,0,0,15,4,1,2
2018-19,Daman Diu,Total,53,0,4,1,26,16,5,1,82,0,3,9,62,7,0,1,0,0,0,0,0,0,0,0,135,0,7,10,88,23,5,2
2018-19,Delhi,Central,493,6,33,97,158,124,49,26,469,8,25,112,165,142,5,12,0,0,0,0,0,0,0,0,962,14,58,209,323,266,54,38
2018-19,Delhi,Crime Branch,0,0,0,0,0,0,0,0,0,0,0,0,0,0,0,0,0,0,0,0,0,0,0,0,0,0,0,0,0,0,0,0
2018-19,Delhi,East,594,1,60,43,246,149,64,31,709,0,57,127,406,87,10,22,0,0,0,0,0,0,0,0,1303,1,117,170,652,236,74,53
2018-19,Delhi,EOW,0,0,0,0,0,0,0,0,0,0,0,0,0,0,0,0,0,0,0,0,0,0,0,0,0,0,0,0,0,0,0,0
2018-19,Delhi,IGI Airport,15,0,0,0,7,6,2,0,5,0,0,0,4,1,0,0,0,0,0,0,0,0,0,0,20,0,0,0,11,7,2,0
2018-19,Delhi,Metro,25,1,1,1,10,5,4,3,13,0,1,2,7,2,1,0,0,0,0,0,0,0,0,0,38,1,2,3,17,7,5,3
2018-19,Delhi,New Delhi,128,1,11,16,52,34,11,3,86,0,5,18,44,9,6,4,0,0,0,0,0,0,0,0,214,1,16,34,96,43,17,7
2018-19,Delhi,North,541,2,25,48,257,158,34,17,577,3,34,136,219,163,14,8,0,0,0,0,0,0,0,0,1118,5,59,184,476,321,48,25
2018-19,Delhi,North-East,1057,9,108,93,461,239,72,75,1380,7,73,269,829,145,25,32,0,0,0,0,0,0,0,0,2437,16,181,362,1290,384,97,107
2018-19,Delhi,North-West,845,5,68,133,345,198,73,23,937,1,74,236,390,201,27,8,0,0,0,0,0,0,0,0,1782,6,142,369,735,399,100,31
2018-19,Delhi,Outer,950,1,58,97,431,229,92,42,1315,2,53,304,696,192,46,22,0,0,0,0,0,0,0,0,2265,3,111,401,1127,421,138,64
2018-19,Delhi,RAILWAY,112,8,11,2,42,27,11,11,92,7,9,2,45,17,6,6,0,0,0,0,0,0,0,0,204,15,20,4,87,44,17,17
2018-19,Delhi,South,796,14,44,111,316,196,80,35,1003,16,60,212,518,144,33,20,0,0,0,0,0,0,0,0,1799,30,104,323,834,340,113,55
2018-19,Delhi,South-East,714,6,69,111,271,151,70,36,972,4,83,228,487,129,27,14,0,0,0,0,0,0,0,0,1686,10,152,339,758,280,97,50
2018-19,Delhi,South-West,557,12,39,62,203,166,64,11,793,17,46,188,369,149,18,6,0,0,0,0,0,0,0,0,1350,29,85,250,572,315,82,17
2018-19,Delhi,Spl Cell,0,0,0,0,0,0,0,0,0,0,0,0,0,0,0,0,0,0,0,0,0,0,0,0,0,0,0,0,0,0,0,0
2018-19,Delhi,SPUWAC,0,0,0,0,0,0,0,0,0,0,0,0,0,0,0,0,0,0,0,0,0,0,0,0,0,0,0,0,0,0,0,0
2018-19,Delhi,Vigilance,0,0,0,0,0,0,0,0,0,0,0,0,0,0,0,0,0,0,0,0,0,0,0,0,0,0,0,0,0,0,0,0
2018-19,Delhi,West,626,0,21,95,320,173,15,2,801,4,37,189,367,188,12,4,0,0,0,0,0,0,0,0,1427,4,58,284,687,361,27,6
2018-19,Delhi,Rohini,835,7,59,136,327,207,76,23,1134,14,67,284,536,183,35,15,0,0,0,0,0,0,0,0,1969,21,126,420,863,390,111,38
2018-19,Delhi,Shahdara,653,6,64,43,254,169,68,49,734,2,62,171,384,79,24,12,0,0,0,0,0,0,0,0,1387,8,126,214,638,248,92,61
2018-19,Delhi,Dwarka,930,6,64,115,264,287,131,63,1222,2,36,302,525,286,37,34,0,0,0,0,0,0,0,0,2152,8,100,417,789,573,168,97
2018-19,Delhi,Outer North,1003,32,121,122,383,223,93,29,1302,19,104,345,634,153,37,10,0,0,0,0,0,0,0,0,2305,51,225,467,1017,376,130,39
2018-19,Delhi,Total,10874,117,856,1325,4347,2741,1009,479,13544,106,826,3125,6625,2270,363,229,0,0,0,0,0,0,0,0,24418,223,1682,4450,10972,5011,1372,708
2018-19,Lakshadweep,Lakshadweep,1,0,0,0,0,1,0,0,0,0,0,0,0,0,0,0,0,0,0,0,0,0,0,0,1,0,0,0,0,1,0,0
2018-19,Lakshadweep,Total,1,0,0,0,0,1,0,0,0,0,0,0,0,0,0,0,0,0,0,0,0,0,0,0,1,0,0,0,0,1,0,0
2018-19,Puducherry,Karaikal,0,0,0,0,0,0,0,0,0,0,0,0,0,0,0,0,0,0,0,0,0,0,0,0,0,0,0,0,0,0,0,0
2018-19,Puducherry,Puducherry,78,2,4,6,25,16,16,9,138,7,10,19,87,4,2,9,0,0,0,0,0,0,0,0,216,9,14,25,112,20,18,18
2018-19,Puducherry,Total,78,2,4,6,25,16,16,9,138,7,10,19,87,4,2,9,0,0,0,0,0,0,0,0,216,9,14,25,112,20,18,18
